word|pinyin
后余|houyu
证码|zhengma
咨询|zixun
汇率|huilv
出现|chuxian
社保|shebao
过个|guoge
园|yuan
期时|qishi
关|guan
盗取|daoqu
我得告|wodegao
到付|daofu
成借贝|chengjiebei
版买|banmai
有信|youxin
买票|maipiao
汽油|qiyou
缴交|jiaojiao
钱到|qiandao
全部一次|quanbuyici
一项|yixiang
星能|xingneng
想关|xiangguan
一种|yizhong
看买|kanmai
钱后|qianhou
转成|zhuancheng
开个|kaige
个体户|getihu
啧啧|zeze
分几|fenji
升额|shenge
网上|wangshang
优惠卷|youhuijuan
今后|jinhou
封闭|fengbi
停|ting
民生银行|minshengyinhang
发校|faxiao
提亮|tiliang
一瓶|yiping
发现|faxian
如禾|ruhe
用酒|yongjiu
未能|weineng
上海银行|shanghaiyinhang
乐意|leyi
看支|kanzhi
没减|meijian
已交|yijiao
没太|meitai
只会用|zhihuiyong
三十天|sanshitian
我付|wofu
花超|huachao
三月|sanyue
查找|chazhao
加到|jiadao
圣诞|shengdan
安卓机|anzhuoji
朋友网|pengyouwang
开童|kaitong
答非所问|dafeisuowen
就要|jiuyao
只后|zhihou
poss|poss
书|shu
映象|yingxiang
借上|jieshang
急病|jibing
手上|shoushang
买过|maiguo
河南省|henansheng
hi|hi
内能|neineng
想变|xiangbian
以经|yijing
扫出|saochu
ill|ill
点下|dianxia
客给|kegei
还够|haigou
人理|renli
同天|tongtian
不够|bugou
夸|kua
评测|pingce
额|e
带长|daizhang
本号|benhao
用开|yongkai
能以|nengyi
机里|jili
大宝|dabao
二立|erli
时确|shique
我先|woxian
天双|tianshuang
跌|die
周四|zhousi
缺钱|queqian
没洗|meixi
有些|youxie
异地|yidi
干|gan
急|ji
付货|fuhuo
限|xian
还入|hairu
看个|kange
收税|shoushui
存货|cunhuo
一群|yiqun
大文出|dawenchu
帮换|banghuan
毛|mao
赌博|dubo
想来|xianglai
揍|zou
月期|yueqi
转号|zhuanhao
ok|ok
配额|peie
无故|wugu
一张|yizhang
再充|zaichong
正好|zhenghao
好几张|haojizhang
选填|xuantian
途中|tuzhong
钱关|qianguan
十几块|shijikuai
推举|tuiju
随意|suiyi
只先|zhixian
元天|yuantian
﻿|﻿
质量|zhiliang
删删|shanshan
帮付|bangfu
看才|kancai
錯|cuo
下降|xiajiang
没办|meiban
总欠|zongqian
存心|cunxin
用户|yonghu
用户名|yonghuming
定投|dingtou
相同|xiangtong
再贷|zaidai
怎事|zenshi
产不|chanbu
查借|chajie
自打|zida
冻结资金|dongjiezijin
病毒|bingdu
分欺|fenqi
千分之|qianfenzhi
提深|tishen
联系人|lianxiren
买错|maicuo
中去|zhongqu
有密|youmi
职消|zhixiao
卡错|kacuo
这期|zheqi
王|wang
贝贝能|beibeineng
换解|huanjie
这时候|zheshihou
已近|yijin
要大过|yaodaguo
尾号|weihao
先借|xianjie
车用|cheyong
七月|qiyue
多会交|duohuijiao
要菅业|yaojianye
还家|haijia
适用|shiyong
仟|qian
整改|zhenggai
发花|fahua
尾巴|weiba
支持|zhichi
如换|ruhuan
五是|wushi
读不起|dubuqi
主义|zhuyi
存里|cunli
刚要|gangyao
换点|huandian
代替|daiti
何情|heqing
帐号|zhanghao
真维斯|zhenweisi
付年费|funianfei
七八|qiba
滑动|huadong
一次性|yicixing
互用|huyong
开业|kaiye
失去|shiqu
通用|tongyong
提会|tihui
履行|lvxing
借用|jieyong
行到|xingdao
我|wo
升值|shengzhi
掏|tao
中钱|zhongqian
切|qie
提不上|tibushang
留下|liuxia
区分|qufen
这比用|zhebiyong
日收|rishou
拿来|nalai
卡着|kazhe
装|zhuang
从此以后|congciyihou
怎么样|zenmeyang
商|shang
扫一|saoyi
人人乐|renrenle
转变成|zhuanbiancheng
九毛|jiumao
个人账户|gerenzhanghu
变后|bianhou
煤|mei
dq|dq
找过|zhaoguo
旗下|qixia
慢|man
螺蛳|luosi
延期付款|yanqifukuan
大约|dayue
息钱|xiqian
折券|zhequan
颜色|yanse
小臂|xiaobi
中行|zhonghang
自主|zizhu
看用|kanyong
sh|sh
高能|gaoneng
二个月|ergeyue
扎|zha
总弄|zongnong
转过|zhuanguo
下分|xiafen
护照|huzhao
后会涨|houhuizhang
咱换|zanhuan
能消|nengxiao
ⅴ|ⅴ
资格|zige
弄用|nongyong
遇期|yuqi
事|shi
龄|ling
要邦定|yaobangding
房|fang
券|quan
疑问|yiwen
开下|kaixia
主页|zhuye
两用|liangyong
上款|shangkuan
转户|zhuanhu
一卡通|yikatong
怪不得|guaibude
没看|meikan
新换|xinhuan
无意间|wuyijian
中要|zhongyao
如可|ruke
专卖|zhuanmai
人用|renyong
起来|qilai
成负|chengfu
退致|tuizhi
银行贷款|yinhangdaikuan
转向|zhuanxiang
路径|lujing
享受|xiangshou
东方|dongfang
期有|qiyou
报告|baogao
算算|suansuan
顺延|shunyan
相差|xiangcha
杂费|zafei
能转|nengzhuan
没差|meicha
有宝|youbao
大以|dayi
安|an
退钱|tuiqian
帜|zhi
第一笔|diyibi
大小|daxiao
易购|yigou
什没|shenmei
回用|huiyong
不快|bukuai
转到子|zhuandaozi
可开|kekai
提额管|tieguan
负面|fumian
跳高|tiaogao
被拉入|beilaru
有效期限|youxiaoqixian
分辨|fenbian
開|kai
不能自己|bunengziji
转用|zhuanyong
手续|shouxu
没邦|meibang
单独|dandu
新增|xinzeng
拼多|pinduo
那点|nadian
程序|chengxu
抢到|qiangdao
ｐ|ｐ
选取|xuanqu
一两次|yiliangci
力度|lidu
行|xing
在读|zaidu
市场|shichang
请求|qingqiu
阶段|jieduan
沒扣|meikou
那一单|nayidan
冬|dong
首付|shoufu
那久|najiu
到现|daoxian
可否|kefou
租机|zuji
蝼蚁|louyi
钱付|qianfu
转哈|zhuanha
百|bai
收钱|shouqian
官|guan
三十多|sanshiduo
如才|rucai
&|&
不对劲|buduijin
手工操作|shougongcaozuo
得话|dehua
电度|diandu
怎是|zenshi
二十多|ershiduo
卡要|kayao
带|dai
按错|ancuo
款数|kuanshu
我领|woling
帮帮|bangbang
天对|tiandui
因人而异|yinreneryi
刚刚开始|ganggangkaishi
配件|peijian
华联|hualian
部分|bufen
贴纸|tiezhi
月份|yuefen
分手|fenshou
解风|jiefeng
活跃|huoyue
版|ban
个体经营|getijingying
按说|anshuo
移到|yidao
可住|kezhu
那算|nasuan
几百|jibai
活期|huoqi
任务|renwu
完够|wangou
没急时|meijishi
对象|duixiang
除夕|chuxi
负值|fuzhi
杀毒|shadu
解困|jiekun
按日|anri
不同|butong
第六天|diliutian
明|ming
千块|qiankuai
隔日|geri
货品|huopin
全号|quanhao
我往|wowang
我市|woshi
什交|shenjiao
那到|nadao
丈夫|zhangfu
当面交易|dangmianjiaoyi
营运证|yingyunzheng
街|jie
二维|erwei
极分|jifen
结算|jiesuan
还部|haibu
玏|le
书包|shubao
交年费|jiaonianfei
变高值|biangaozhi
尚未|shangwei
好几个|haojige
点刚|diangang
享有|xiangyou
处境|chujing
透资|touzi
催下|cuixia
退退|tuitui
手机号|shoujihao
多大能|duodaneng
开房|kaifang
信运度|xinyundu
同意书|tongyishu
账是|zhangshi
我用|woyong
油站|youzhan
两份|liangfen
要算|yaosuan
循化|xunhua
里购|ligou
购|gou
分日|fenri
完事|wanshi
顺利|shunli
回往|huiwang
液晶电视|yejingdianshi
还法|haifa
随便|suibian
第二个|dierge
会到|huidao
来自|laizi
存有|cunyou
日迟|richi
可怕|kepa
职能|zhineng
加入|jiaru
稳定|wending
充了|chongle
可随|kesui
卡能|kaneng
越换|yuehuan
福|fu
谓|wei
全在|quanzai
能联|nenglian
有木有|youmuyou
能作|nengzuo
注意事项|zhuyishixiang
vo|vo
说哈|shuoha
已退|yitui
大概|dagai
宽带|kuandai
怎领|zenling
会口|huikou
截|jie
问用|wenyong
永辉|yonghui
哪钱|naqian
发展|fazhan
卡换|kahuan
补充|buchong
点样|dianyang
几月份|jiyuefen
后清|houqing
条|tiao
冰室|bingshi
集盒|jihe
材料|cailiao
优选|youxuan
开不起|kaibuqi
良好|lianghao
那升|nasheng
秒|miao
过后|guohou
就关|jiuguan
反倍|fanbei
摇一摇会|yaoyiyaohui
新用|xinyong
二笔|erbi
财产险|caichanxian
最先|zuixian
借呗|jiebei
两天|liangtian
注意|zhuyi
七十多块|qishiduokuai
许可证|xukezheng
顶替|dingti
谁动|sheidong
掌上|zhangshang
囗|wei
店子|dianzi
总提|zongti
差额|chae
负时|fushi
同一天|tongyitian
开来|kailai
补全|buquan
接过|jieguo
岁|sui
非得|feidei
细则|xize
遍|bian
日用|riyong
共借|gongjie
首付款|shoufukuan
十二分|shierfen
解卡|jieka
总让|zongrang
有大|youda
本人|benren
一二点|yierdian
那付|nafu
租|zu
销了|xiaole
关不关|guanbuguan
购与|gouyu
取回|quhui
身上|shenshang
要花|yaohua
沒有減|meiyoujian
时扫|shisao
借下个|jiexiage
全不|quanbu
一点儿|yidianer
清完|qingwan
萌店|mengdian
意义|yiyi
开动|kaidong
出款|chukuan
两周|liangzhou
压力锅|yaliguo
管用|guanyong
拜托|baituo
扫错|saocuo
三四年|sansinian
负额|fue
将额|jiange
不需|buxu
电车|dianche
懂点|dongdian
恶作剧|ezuoju
能先|nengxian
开口|kaikou
出自|chuzi
期免|qimian
日时|rishi
在生活上|zaishenghuoshang
温暖|wennuan
医疗|yiliao
回长|huizhang
两遍|liangbian
用住|yongzhu
延后|yanhou
繁体|fanti
收花贝|shouhuabei
买不到|maibudao
块儿|kuaier
归还给|guihuangei
利后|lihou
话题|huati
这话|zhehua
二十多天|ershiduotian
传至|chuanzhi
这俩|zhelia
iphonex|iphonex
减退|jiantui
机票|jipiao
小吃|xiaochi
三万元|sanwanyuan
台湾|taiwan
邦定|bangding
藏宝阁|cangbaoge
唄买个|beimaige
砸|za
换过来|huanguolai
过能|guoneng
存卡能|cunkaneng
太难|tainan
冲费|chongfei
相加|xiangjia
买进|maijin
那充|nachong
非议|feiyi
分天|fentian
深情|shenqing
填完|tianwan
调成|diaocheng
运动|yundong
宗|zong
投了|toule
十块|shikuai
加大|jiada
受|shou
好几千|haojiqian
开新|kaixin
转不出|zhuanbuchu
提供|tigong
客|ke
数加|shujia
公共事业|gonggongshiye
看看|kankan
扔|reng
建议您|jianyinin
多收|duoshou
紧急|jinji
哪查|nacha
其实|qishi
178|178
加锁|jiasuo
彩票|caipiao
扣押|kouya
费费|feifei
store|store
hu|hu
降分|jiangfen
批下来|pixialai
拥挤|yongji
不低|budi
法人代表|farendaibiao
看来|kanlai
关闭|guanbi
降单|jiangdan
扛|kang
他用|tayong
卅|sa
履有|lvyou
吹款|chuikuan
还主号|haizhuhao
借得|jiede
刷卡机|shuakaji
消|xiao
备注|beizhu
确用|queyong
号发|haofa
不出|buchu
点退|diantui
上午|shangwu
券少|quanshao
手机用户|shoujiyonghu
还接|haijie
宝用|baoyong
结开|jiekai
取向|quxiang
交款|jiaokuan
规则|guize
qqb|qqb
尾|wei
固定|guding
销售额|xiaoshoue
不睬|bucai
a|a
kaih|kaih
还算|haisuan
刷新|shuaxin
后退|houtui
机器|jiqi
进帐|jinzhang
口马|kouma
两边|liangbian
文件|wenjian
星星|xingxing
不满|buman
峰期|fengqi
尽时|jinshi
六个|liuge
认识|renshi
中石化|zhongshihua
端的|duande
一借|yijie
钱次|qianci
有多单|youduodan
住店|zhudian
聚美|jumei
力及|liji
元末|yuanmo
元购|yuangou
用捕|yongbu
多到|duodao
人脸|renlian
转多|zhuanduo
手中|shouzhong
瓜分|guafen
邀约|yaoyue
外套|waitao
借账|jiezhang
日借|rijie
级别|jibie
挂备|guabei
扣除|kouchu
空|kong
我满|woman
一只|yizhi
电脑|diannao
交固话|jiaoguhua
想子|xiangzi
单打|danda
保留|baoliu
于额|yue
还记|haiji
抓|zhua
下个星期|xiagexingqi
早己|zaoji
交不上|jiaobushang
额会|ehui
记录|jilu
大衣|dayi
82|82
纸|zhi
蓝小蓝|lanxiaolan
报|bao
我积|woji
办|ban
纳费|nafei
尔度|erdu
必备|bibei
属于|shuyu
金鹰|jinying
药品|yaopin
灯笼|denglong
裙子|qunzi
价格|jiage
咋调|zadiao
小额贷款|xiaoedaikuan
一二天|yiertian
退入|tuiru
挖到|wadao
受不了|shoubuliao
kdv|kdv
多|duo
复制|fuzhi
查是|chashi
款行|kuanxing
费率|feilv
陶|tao
如口|rukou
另一台|lingyitai
代金|daijin
热线电话|rexiandianhua
登记|dengji
蚂蚁|mayi
一扫|yisao
提示卡|tishika
十一点|shiyidian
另一只|lingyizhi
能帮|nengbang
剩下|shengxia
滴滴|didi
危机|weiji
多不提|duobuti
不利|buli
主机|zhuji
挖奖|wajiang
海域|haiyu
卷券|juanquan
有病|youbing
多月|duoyue
个星|gexing
卖完|maiwan
后边|houbian
结果显示|jieguoxianshi
没来|meilai
136|136
挂钩|guagou
能结|nengjie
贷商|daishang
作为|zuowei
仍|reng
服帮|fubang
生活费|shenghuofei
鸣|ming
想升|xiangsheng
我买个|womaige
金燕卡|jinyanka
更|geng
计算方法|jisuanfangfa
换下|huanxia
保险公司|baoxiangongsi
后出|houchu
完想|wanxiang
高于|gaoyu
有通|youtong
采暖费|cainuanfei
十几元|shijiyuan
不爽|bushuang
像是|xiangshi
广|guang
办到|bandao
款多|kuanduo
种|zhong
为设|weishe
暂|zan
境内|jingnei
用拉|yongla
食品卫生|shipinweisheng
优步|youbu
先存|xiancun
收银|shouyin
佰元|baiyuan
一哈|yiha
补不卡|bubuka
收得|shoude
一退|yitui
差|cha
一比款|yibikuan
鼠标|shubiao
图库|tuku
花交|huajiao
若免|ruomian
能减|nengjian
文字|wenzi
指明|zhiming
改价|gaijia
借叹|jietan
用尽|yongjin
赋予|fuyu
报错|baocuo
完不借|wanbujie
那收|nashou
卡绑|kabang
需求|xuqiu
走超|zouchao
起诉|qisu
叫网|jiaowang
经营者|jingyingzhe
机构|jigou
隔越|geyue
这项|zhexiang
建议|jianyi
金|jin
四五个|siwuge
见效|jianxiao
整错|zhengcuo
网校|wangxiao
上摇一摇|shangyaoyiyao
总价|zongjia
我迟|wochi
信货|xinhuo
扣上|koushang
四千|siqian
岂|qi
外访|waifang
冲个|chongge
灵|ling
提金|tijin
能变|nengbian
专车|zhuanche
十足|shizu
陌币|mobi
按万|anwan
补发|bufa
妈妈|mama
找人带|zhaorendai
平估|pinggu
金正|jinzheng
互是|hushi
合家|hejia
房东|fangdong
大陆|dalu
猪|zhu
保持良好|baochilianghao
晶杰|jingjie
现现|xianxian
本复息|benfuxi
换前|huanqian
日出|richu
循环|xunhuan
七十|qishi
龙有|longyou
条约|tiaoyue
情圈|qingquan
它|ta
借人用|jierenyong
经营|jingying
刮到|guadao
事实上|shishishang
每周|meizhou
改嘛|gaima
转交|zhuanjiao
负后|fuhou
星球|xingqiu
谢|xie
丢钱|diuqian
共分|gongfen
前要|qianyao
相片|xiangpian
收益率|shouyilv
寶要|baoyao
iphone|iphone
这单|zhedan
以及|yiji
没入|moru
美食|meishi
提示音|tishiyin
可行|kexing
用不完|yongbuwan
锦顺|jinshun
马上转|mashangzhuan
下滑|xiahua
证件|zhengjian
里边儿|libianer
要是|yaoshi
那有|nayou
佘额宝|sheebao
分次|fenci
当晚|dangwan
挺高|tinggao
蛋糕店|dangaodian
选选|xuanxuan
题|ti
江西省|jiangxisheng
支什宝|zhishenbao
一天两天|yitianliangtian
营业厅|yingyeting
起升|qisheng
机器人|jiqiren
处理|chuli
一号|yihao
密付付|mifufu
按钮|anniu
完|wan
五万|wuwan
更感|genggan
准入条件|zhunrutiaojian
错开|cuokai
証|zheng
损坏|sunhuai
如何|ruhe
中心|zhongxin
涨点|zhangdian
证户|zhenghu
最初|zuichu
转送|zhuansong
统一|tongyi
两双|liangshuang
设置|shezhi
不支|buzhi
具体情况|jutiqingkuang
周|zhou
代销|daixiao
长沙|changsha
跑腿|paotui
快件|kuaijian
没意思|meiyisi
说来说去|shuolaishuoqu
有卡上|youkashang
用付|yongfu
违约金|weiyuejin
开点|kaidian
信度|xindu
关毕|guanbi
增多|zengduo
解解|jiejie
目的地|mudidi
撤回来|chehuilai
一值|yizhi
马后|mahou
吸|xi
天有|tianyou
重装|zhongzhuang
没补|meibu
用后|yonghou
我租|wozu
谢谢你们|xiexienimen
整么关|zhengmeguan
需票|xupiao
超支|chaozhi
贷|dai
付对|fudui
跟主|genzhu
初次|chuci
算错|suancuo
有账|youzhang
怎办|zenban
一年期|yinianqi
问哈|wenha
有购|yougou
不到|budao
安日|anri
一月|yiyue
店开|diankai
几万|jiwan
不关|buguan
后算|housuan
短消息|duanxiaoxi
皇城|huangcheng
帐付|zhangfu
疯狂|fengkuang
问提|wenti
反映|fanying
业务费|yewufei
百不|baibu
重填|zhongtian
双倍|shuangbei
尽量少|jinliangshao
红色|hongse
学费|xuefei
电子|dianzi
只想关|zhixiangguan
完在|wanzai
达买|damai
骑单车|qidanche
漏洞|loudong
别的|biede
卡卷|kajuan
通宵|tongxiao
家用|jiayong
一家人|yijiaren
平均|pingjun
跟|gen
原件|yuanjian
移动|yidong
揭开|jiekai
绿卡|lvka
元免|yuanmian
相差太大|xiangchataida
代付款|daifukuan
必要|biyao
乡|xiang
一千三百|yiqiansanbai
泝|su
ofo|ofo
本想|benxiang
察|cha
春节|chunjie
关点|guandian
二十四点|ershisidian
迟俩|chilia
起输|qishu
改正|gaizheng
没贷|meidai
戒面|jiemian
五选|wuxuan
不动会算|budonghuisuan
增大|zengda
审理|shenli
超限|chaoxian
我额|woe
环清|huanqing
银行卡|yinhangka
车险|chexian
样|yang
抽天|choutian
一两个|yiliangge
银行业务|yinhangyewu
美图|meitu
必胜客|bishengke
账|zhang
买卖双方|maimaishuangfang
只要|zhiyao
元喃|yuannan
给我发|geiwofa
收不钱|shoubuqian
不一至|buyizhi
冲有|chongyou
结用|jieyong
帮定|bangding
纸能|zhineng
原因|yuanyin
货后|huohou
分宝|fenbao
能永|nengyong
变动|biandong
专款|zhuankuan
年息|nianxi
钱以|qianyi
注明|zhuming
提升|tisheng
售价|shoujia
已换|yihuan
代扣代缴|daikoudaijiao
管掉|guandiao
店内|diannei
不白开|bubaikai
容易|rongyi
穿|chuan
点击|dianji
更高|genggao
周转|zhouzhuan
就行了|jiuxingle
贸易|maoyi
优拜|youbai
现额|xiane
查不到|chabudao
就行|jiuxing
立减|lijian
抢红包|qianghongbao
加点|jiadian
计帐|jizhang
美女|meinv
连美图|lianmeitu
那单|nadan
昨天早上|zuotianzaoshang
不会|buhui
木头|mutou
好象|haoxiang
刚关|gangguan
第八期|dibaqi
不至于|buzhiyu
百分之零点|baifenzhilingdian
承担费用|chengdanfeiyong
多次|duoci
延迟|yanchi
扣扣|koukou
箱子|xiangzi
留言|liuyan
九元|jiuyuan
处|chu
分清|fenqing
居体|juti
小钱|xiaoqian
差到|chadao
好点|haodian
加油卡|jiayouka
住院|zhuyuan
公用|gongyong
同样|tongyang
我本|woben
交付|jiaofu
最多涨|zuiduozhang
银发|yinfa
催债|cuizhai
相对|xiangdui
已有|yiyou
分高开|fengaokai
先充|xianchong
天津|tianjin
下线|xiaxian
停止使用|tingzhishiyong
恒定|hengding
有弹|youdan
那种|nazhong
交上|jiaoshang
拍下|paixia
被纷|beifen
资金不足|zijinbuzu
赶|gan
已款|yikuan
别个|biege
推送|tuisong
民办教育|minbanjiaoyu
度来|dulai
搞机|gaoji
来临|lailin
没变少|meibianshao
改长|gaizhang
催款|cuikuan
冋|jiong
一付|yifu
容忍度|rongrendu
支出|zhichu
千快|qiankuai
会手|huishou
抢钱|qiangqian
收起|shouqi
使用权|shiyongquan
收款台|shoukuantai
会涨|huizhang
没上|meishang
人代|rendai
款会|kuanhui
强烈建议|qiangliejianyi
交气费|jiaoqifei
le|le
掉级|diaoji
一年|yinian
邮局|youju
第|di
要点|yaodian
单天能|dantianneng
加多|jiaduo
快去|kuaiqu
缴固话|jiaoguhua
故意|guyi
多存点|duocundian
能差|nengcha
自从|zicong
确是|queshi
兄弟|xiongdi
欠数|qianshu
不太好|butaihao
高学历|gaoxueli
资料|ziliao
捷信|jiexin
审查|shenzha
能收|nengshou
欢有|huanyou
所以|suoyi
几款|jikuan
刷错|shuacuo
还现|haixian
秦|qin
成年|chengnian
对接|duijie
查帐|zhazhang
想起|xiangqi
春天|chuntian
shi|shi
盗走|daozou
还会手|haihuishou
付得|fude
元鸡|yuanji
系统对|xitongdui
守约|shouyue
万能|wanneng
宝能|baoneng
经过|jingguo
储存卡|chucunka
时候|shihou
口子|kouzi
后来|houlai
上交|shangjiao
完变|wanbian
款现|kuanxian
韩国|hanguo
好友|haoyou
堤升|disheng
强关|qiangguan
哪调|nadiao
手续费|shouxufei
额宝|ebao
怎能|zenneng
两种|liangzhong
crm|crm
照常|zhaochang
我为|wowei
剁|duo
失效|shixiao
我行|woxing
今晚|jinwan
总结|zongjie
免缴|mianjiao
令|ling
无法|wufa
记帐|jizhang
付能|funeng
使用期|shiyongqi
似乎|sihu
已为|yiwei
老张|laozhang
券包|quanbao
这条|zhetiao
降回来|jianghuilai
上购|shanggou
样能|yangneng
黑屏|heiping
用光|yongguang
歪歪|waiwai
会免|huimian
买点|maidian
空卡|kongka
后美团|houmeituan
标注|biaozhu
浮动|fudong
新办|xinban
单号|danhao
卷换|juanhuan
往次|wangci
当日|dangri
类|lei
总是|zongshi
丟了|diule
嘟|du
能到|nengdao
我美|womei
法|fa
全退|quantui
忘|wang
领用|lingyong
买到|maidao
跟期|genqi
黄车|huangche
看出|kanchu
不良|buliang
瑜伽|yujia
中多|zhongduo
几十万|jishiwan
迈|mai
亏了|kuile
贩|fan
阿里巴巴|alibaba
五百块|wubaikuai
完就关|wanjiuguan
挑件|tiaojian
最多交|zuiduojiao
当是|dangshi
你点|nidian
改版|gaiban
一长|yizhang
我全|woquan
鼻|bi
打款|dakuan
付款|fukuan
黑名单|heimingdan
几天|jitian
转为|zhuanwei
三次|sanci
票价|piaojia
券该|quangai
提伸|tishen
还原成|huanyuancheng
一定|yiding
多余|duoyu
南宁|nanning
实名制|shimingzhi
对不上|duibushang
长期性|changqixing
未用过|weiyongguo
那款|nakuan
阿迪|adi
关备|guanbei
再见|zaijian
分扣|fenkou
快巴|kuaiba
买单|maidan
fang|fang
这杂|zheza
这欠|zheqian
寄|ji
分号|fenhao
shoudl|shoudl
没法|meifa
分加|fenjia
死用|siyong
她家|tajia
扣到|koudao
九月九|jiuyuejiu
免额期|mianeqi
变成|biancheng
未找到|weizhaodao
网关|wangguan
少退|shaotui
借完|jiewan
能套|nengtao
换过|huanguo
執|zhi
想永|xiangyong
物资|wuzi
按天|antian
构成|goucheng
嘞|lei
上下|shangxia
咋会事|zahuishi
甲|jia
出来|chulai
欢上|huanshang
脸里|lianli
商业|shangye
卖家|maijia
日后|rihou
单在|danzai
测脸|celian
无辜|wugu
不先|buxian
店部|dianbu
医药费|yiyaofei
一生|yisheng
加上|jiashang
撤|che
网|wang
付钱|fuqian
三百元|sanbaiyuan
点多|dianduo
良心|liangxin
不冲减|buchongjian
店付|dianfu
填|tian
机上|jishang
发微信|faweixin
介入|jieru
etc|etc
千万别|qianwanbie
合算|hesuan
最长|zuizhang
会多要|huiduoyao
共|gong
去试|qushi
本地|bendi
习惯|xiguan
哪网|nawang
版面|banmian
张卡|zhangka
付全|fuquan
审请|shenqing
会开|huikai
玩游戏|wanyouxi
.....|.....
建|jian
人期|renqi
haiz|haiz
自动|zidong
怎让|zenrang
来分|laifen
人有|renyou
唄為|beiwei
原样|yuanyang
认可|renke
吃饭|chifan
上天|shangtian
数额较大|shuejiaoda
59|59
要说|yaoshuo
利润|lirun
毛病|maobing
大型超市|daxingchaoshi
二维码|erweima
请用|qingyong
一百多元|yibaiduoyuan
没反现|meifanxian
还确|haique
有机|youji
开熊|kaixiong
团队|tuandui
章|zhang
哪一天|nayitian
利希|lixi
名字|mingzi
弟弟|didi
转不进|zhuanbujin
补领|buling
首期|shouqi
洞结|dongjie
古装|guzhuang
信誉|xinyu
数最多|shuzuiduo
美甲|meijia
网用|wangyong
就算|jiusuan
可选|kexuan
甚|shen
退个款|tuigekuan
何为|hewei
换过去|huanguoqu
门诊|menzhen
笔笔|bibi
九九|jiujiu
推款|tuikuan
迟后|chihou
开房间|kaifangjian
买动西|maidongxi
运用|yunyong
付后|fuhou
关机|guanji
问题|wenti
不光|buguang
办俩|banlia
崇左市|chongzuoshi
套出|taochu
通讯录|tongxunlu
难道|nandao
北国|beiguo
上卖|shangmai
仅仅|jinjin
木|mu
交费用|jiaofeiyong
石家庄|shijiazhuang
借钱|jieqian
口令|kouling
反倒|fandao
某个|mouge
证下|zhengxia
利希高|lixigao
妈呀|maya
新机|xinji
下此|xiaci
竟然|jingran
陌|mo
刚能|gangneng
换现|huanxian
tongguo|tongguo
√|√
完是|wanshi
钱边|qianbian
答到|dadao
简易|jianyi
谝|pian
借款单|jiekuandan
无资格|wuzige
意思|yisi
先本|xianben
星期|xingqi
近期|jinqi
才行|caixing
短时间|duanshijian
八块|bakuai
微信|weixin
照样|zhaoyang
还会变|haihuibian
允许|yunxu
利略|lilve
每|mei
柜子|guizi
98|98
小卖|xiaomai
一百万|yibaiwan
派出所|paichusuo
重买|zhongmai
设定|sheding
现金额|xianjine
挂牌|guapai
我换|wohuan
我巳经|wosijing
负分|fufen
成给|chenggei
充过|chongguo
十八岁|shibasui
大米|dami
照照|zhaozhao
水果|shuiguo
网贷会|wangdaihui
福卡|fuka
付美团|fumeituan
拖点|tuodian
还码|haima
出门在外|chumenzaiwai
以致|yizhi
从有到无|congyoudaowu
款分|kuanfen
单车|danche
怎己|zenji
现已|xianyi
多付|duofu
啥意思|shayisi
最高点|zuigaodian
调嘛|diaoma
后收|houshou
用得着|yongdezhe
借巴|jieba
服务类型|fuwuleixing
提交|tijiao
包用|baoyong
顺序|shunxu
周六|zhouliu
续贷|xudai
电脑操作|diannaocaozuo
九点半|jiudianban
代码|daima
无人|wuren
期想|qixiang
征样|zhengyang
手款|shoukuan
坯布|pibu
切款|qiekuan
检测|jiance
操过|caoguo
请款|qingkuan
农商|nongshang
却说|queshuo
二十几元|ershijiyuan
多开|duokai
sfb|sfb
另一半|lingyiban
二期|erqi
我哈|woha
万宁|wanning
挪到|nuodao
酒仙|jiuxian
先付|xianfu
惊喜|jingxi
我安期|woanqi
佰迪乐|baidile
然是|ranshi
该成|gaicheng
招联|zhaolian
重叠|chongdie
别样|bieyang
┃|┃
的话|dehua
两千元|liangqianyuan
点用|dianyong
总之|zongzhi
bie|bie
删不掉|shanbudiao
买卖|maimai
会变|huibian
格外|gewai
登号|denghao
唔|wu
过千|guoqian
攒|zan
上订|shangding
现买|xianmai
激请|jiqing
时出|shichu
开玩|kaiwan
万几|wanji
时算|shisuan
鉴先利后|jianxianlihou
眨|zha
好转|haozhuan
商人|shangren
卡后|kahou
有应|youying
无效|wuxiao
万达|wanda
本款|benkuan
花花|huahua
天内|tiannei
免扣|miankou
相反|xiangfan
我特|wote
七百|qibai
提钱|tiqian
入驻|ruzhu
点选|dianxuan
拖期|tuoqi
ㄥ|ㄥ
订餐|dingcan
发送|fasong
听到|tingdao
通道|tongdao
有微|youwei
中租机|zhongzuji
积花|jihua
我心|woxin
形成|xingcheng
剑|jian
确实|queshi
制做|zhizuo
急事|jishi
这用|zheyong
替代|tidai
赚钱|zhuanqian
凭据|pingju
还车|haiche
一百多块|yibaiduokuai
通开|tongkai
成万|chengwan
这换|zhehuan
真实|zhenshi
门口|menkou
贷记卡|daijika
退返|tuifan
我花臂|wohuabi
包在|baozai
都行|douxing
贴能|tieneng
形象|xingxiang
租房|zufang
每张|meizhang
复印件|fuyinjian
我托|wotuo
多久|duojiu
像|xiang
冲油卡|chongyouka
条码|tiaoma
上海|shanghai
何如|heru
令外|lingwai
桂盛卡|guishengka
九月底|jiuyuedi
之付|zhifu
骆驼|luotuo
展开|zhankai
度数|dushu
反而|faner
帮助|bangzhu
⊙|⊙
微商|weishang
横线|hengxian
梆|bang
会少|huishao
大年初一|danianchuyi
售卖机|shoumaiji
盛|sheng
流量|liuliang
作|zuo
去世|qushi
花完|huawan
徽信|huixin
四年|sinian
转换成|zhuanhuancheng
先查|xiancha
一欠|yiqian
森林|senlin
超日|chaori
退款|tuikuan
不期|buqi
十多个|shiduoge
普吉岛|pujidao
刚得|gangde
多关|duoguan
少部分|shaobufen
组合|zuhe
越用|yueyong
内页|neiye
从没|congmei
別|bie
该付|gaifu
解决问题|jiejuewenti
前额|qiane
快|kuai
一提|yiti
g|g
难到|nandao
收不到|shoubudao
能量|nengliang
怎才|zencai
三元|sanyuan
新世纪|xinshiji
目录|mulu
能待款|nengdaikuan
周六日|zhouliuri
底|di
没开|meikai
肯定|kending
用品|yongpin
前些天|qianxietian
证实|zhengshi
先要|xianyao
fu|fu
感是|ganshi
专用|zhuanyong
填好|tianhao
挨|ai
再|zai
提不出|tibuchu
现在|xianzai
干吗|ganma
业务员|yewuyuan
知晓|zhixiao
蜀|shu
缴电|jiaodian
十天|shitian
每日|meiri
却关|queguan
赏金|shangjin
要么|yaome
骗|pian
买电|maidian
商务|shangwu
仅限于|jinxianyu
下款|xiakuan
环|huan
玩款|wankuan
拓展|tuozhan
退掉|tuidiao
中花|zhonghua
莫非|mofei
我加购|wojiagou
早已|zaoyi
缴款|jiaokuan
还款期|haikuanqi
结日会|jierihui
伊尔|yier
赞|zan
耽搁|dange
比款|bikuan
尽量|jinliang
汽车信息|qichexinxi
体|ti
老爸|laoba
分会|fenhui
免费|mianfei
近几天|jinjitian
数为|shuwei
自动售货机|zidongshouhuoji
面有|mianyou
朋友|pengyou
终结|zhongjie
免提|mianti
栏目|lanmu
友宝|youbao
弄成|nongcheng
不经意|bujingyi
率利|lvli
升降|shengjiang
仔|zai
险要|xianyao
p|p
分期|fenqi
会退|huitui
托儿|tuoer
小数|xiaoshu
影视|yingshi
安时|anshi
趸|dun
完期|wanqi
以经邦定|yijingbangding
少会|shaohui
六小时|liuxiaoshi
一能|yineng
后天|houtian
人头像|rentouxiang
本息|benxi
傅|fu
聚合|juhe
指定|zhiding
利|li
没钱码|meiqianma
折扣|zhekou
主体|zhuti
校验|jiaoyan
一千只|yiqianzhi
收重|shouzhong
求解|qiujie
铺|pu
不通|butong
中设|zhongshe
我勒|wolei
这办|zheban
时间|shijian
准备|zhunbei
回有|huiyou
我想贷|woxiangdai
上月款|shangyuekuan
两万|liangwan
宁|ning
没有用完|meiyouyongwan
一百二十|yibaiershi
钱该|qiangai
单利|danli
佘额|shee
受权|shouquan
体彩|ticai
但票|danpiao
元摩拜|yuanmobai
我带|wodai
计账|jizhang
调减|diaojian
为主|weizhu
设立|sheli
喻欺|yuqi
一百一十二|yibaiyishier
实名|shiming
隐藏|yincang
花百|huabai
无端|wuduan
经贴|jingtie
桌面|zhuomian
手动|shoudong
度降|dujiang
出钱|chuqian
右上角|youshangjiao
腾讯|tengxun
股票|gupiao
免掉|miandiao
加已|jiayi
确认|queren
四未|siwei
杂退|zatui
室|shi
错帮|cuobang
快给我|kuaigeiwo
除消|chuxiao
改写|gaixie
指上|zhishang
要够|yaogou
置换|zhihuan
总金额|zongjine
充微|chongwei
变黑|bianhei
芝麻|zhima
还爸|haiba
贴津|tiejin
二手|ershou
下个月|xiageyue
志加|zhijia
银行帐号|yinhangzhanghao
刚交|gangjiao
密能|mineng
五十五|wushiwu
按照|anzhao
我话|wohua
后能结|hounengjie
由情|youqing
小兰|xiaolan
收款码|shoukuanma
有要|youyao
几分钟|jifenzhong
领的券|lingdequan
我想存|woxiangcun
嗎|ma
高考|gaokao
中来|zhonglai
15|15
补卡后|bukahou
为首|weishou
事先|shixian
卡消费|kaxiaofei
对放|duifang
开放|kaifang
一进|yijin
知前|zhiqian
自带|zidai
走|zou
二十六|ershiliu
两三次|liangsanci
互请|huqing
还额|haie
过半|guoban
第一期|diyiqi
上市|shangshi
不就行|bujiuxing
为先|weixian
十一个月|shiyigeyue
一日|yiri
工商户|gongshanghu
壹佰元|yibaiyuan
惹|re
一堆|yidui
一套|yitao
发过来|faguolai
赖账|laizhang
伸|shen
专门|zhuanmen
大额|dae
按过|anguo
要算进|yaosuanjin
拥有|yongyou
第一|diyi
真的假|zhendejia
密付|mifu
代换|daihuan
安心|anxin
猜|cai
白花|baihua
俞期费|yuqifei
网易|wangyi
分期付款|fenqifukuan
记|ji
收去|shouqu
互联|hulian
缴纳|jiaona
首位|shouwei
一扣|yikou
新手机|xinshouji
卷能|juanneng
懂吗|dongma
请密|qingmi
能|neng
欹|yi
按道理说|andaolishuo
冲不起|chongbuqi
提下额|tixiae
逾期费|yuqifei
同一|tongyi
结转|jiezhuan
度为|duwei
抢免|qiangmian
28|28
只出|zhichu
澳洲|aozhou
不服|bufu
打|da
履约|lvyue
未到|weidao
我晚|wowan
店入|dianru
那笔|nabi
开发|kaifa
老娘|laoniang
按键|anjian
de|de
搂|lou
五年|wunian
款去|kuanqu
屈臣氏|quchenshi
不扫|busao
比比|bibi
末|mo
新号|xinhao
十六号|shiliuhao
关后|guanhou
夏天|xiatian
一个半月|yigebanyue
接近|jiejin
转|zhuan
网商袋|wangshangdai
智能|zhineng
锁定|suoding
需要|xuyao
改期|gaiqi
公共|gonggong
新疆地区|xinjiangdiqu
花下|huaxia
欢乐|huanle
昨日|zuori
截图|jietu
又会有|youhuiyou
打个比方|dagebifang
已用|yiyong
款到|kuandao
用充|yongchong
会拉黑|huilahei
货己|huoji
最高|zuigao
会|hui
元旦|yuandan
直前|zhiqian
见到|jiandao
会有|huiyou
分开|fenkai
二字|erzi
当摩拜|dangmobai
长利|zhangli
暴长|baozhang
壮态|zhuangtai
负用|fuyong
銀行|yinxing
全了|quanle
没法用|meifayong
洗衣机|xiyiji
封花|fenghua
没额额|meiee
手快|shoukuai
公安|gongan
黑户|heihu
纪录|jilu
六千多|liuqianduo
本本|benben
该期|gaiqi
乱够|luangou
各地|gede
询问|xunwen
战|zhan
重新启动|chongxinqidong
复|fu
微贷|weidai
消账|xiaozhang
用处|yongchu
店方|dianfang
当场|dangchang
弱|ruo
强烈|qianglie
找人代|zhaorendai
密码锁|mimasuo
组高|zugao
国庆节|guoqingjie
有钱|youqian
拉黑|lahei
券是|quanshi
不解|bujie
紅包|hongbao
维护|weihu
只能|zhineng
延长时间|yanchangshijian
车主|chezhu
退嘛|tuima
角|jiao
设有|sheyou
营业证|yingyezheng
端|duan
发么|fame
擅自|shanzi
几日|jiri
没倒|meidao
后能|houneng
收据|shouju
按天算|antiansuan
先息候|xianxihou
两次|liangci
天未|tianwei
开工|kaigong
媛|yuan
耐药|naiyao
钱缺|qianque
大多|daduo
十笔|shibi
启动|qidong
购后|gouhou
晓得|xiaode
跳|tiao
来得及|laideji
加倍|jiabei
还颗|haike
愿意|yuanyi
奇妙|qimiao
开过|kaiguo
副本|fuben
失用|shiyong
数不对|shubudui
怎找|zenzhao
鉴定|jianding
偷|tou
娱乐|yule
刷卡|shuaka
储存|chucun
蚂蜂|mafeng
回事儿|huishier
没送|meisong
两方|liangfang
说本|shuoben
能替|nengti
提款|tikuan
没想到|meixiangdao
前几日|qianjiri
取晓|quxiao
没变|meibian
里点|lidian
周卡永辉|zhoukayonghui
zf|zf
現在|xianzai
负想|fuxiang
已扣|yikou
不定期|budingqi
咋点|zadian
哪看|nakan
交费|jiaofei
哈小黄|haxiaohuang
首月用|shouyueyong
会计|kuaiji
其别|qibie
站|zhan
替换|tihuan
当当网|dangdangwang
欠账|qianzhang
反应|fanying
别外|biewai
粉丝|fensi
指纹|zhiwen
别人|bieren
刚分|gangfen
刚进|gangjin
一行|yixing
店有|dianyou
额到|edao
寶|bao
线下|xianxia
显得|xiande
保单|baodan
度不高|dubugao
慢慢|manman
很久以前|henjiuyiqian
六百多|liubaiduo
请空|qingkong
南京|nanjing
花期|huaqi
盆友|penyou
此人|ciren
分级|fenji
游戏|youxi
梦|meng
赶紧|ganjin
证|zheng
自动识别|zidongshibie
八十九|bashijiu
赢|ying
信息费|xinxifei
还点|haidian
己付|jifu
湖|hu
中间|zhongjian
可是|keshi
大过|daguo
上一年|shangyinian
yue|yue
用回|yonghui
没天|meitian
哪会|nahui
扯|che
单日|danri
权益日|quanyiri
连贯|lianguan
度用|duyong
交错|jiaocuo
可借|kejie
精灵|jingling
弃用|qiyong
退进|tuijin
一百七十多|yibaiqishiduo
从未有过|congweiyouguo
豆浆|doujiang
分提|fenti
计算出来|jisuanchulai
周三|zhousan
小孩|xiaohai
上尼|shangni
升分|shengfen
发在|fazai
结情|jieqing
随|sui
卡来|kalai
没|mei
宽限|kuanxian
出对|chudui
领券|lingquan
捐|juan
清理|qingli
第三方|disanfang
以今|yijin
手机短信|shoujiduanxin
泄露|xielou
月租|yuezu
天看|tiankan
用来用去|yonglaiyongqu
券能|quanneng
二千块|erqiankuai
两三年|liangsannian
第二回|dierhui
下边|xiabian
充冲|chongchong
端游|duanyou
数码|shuma
花掉|huadiao
下期|xiaqi
函|han
配置|peizhi
没过多久|moguoduojiu
出镜|chujing
一万|yiwan
刚到|gangdao
扥|den
改小|gaixiao
企业法人|qiyefaren
戟|ji
商好|shanghao
缴费|jiaofei
第一位|diyiwei
开放平台|kaifangpingtai
跳上去|tiaoshangqu
巴斯|basi
三百多|sanbaiduo
其会|qihui
日退|ritui
交话|jiaohua
哆啦宝|duolabao
月结|yuejie
输错|shucuo
透|tou
领取|lingqu
临时工|linshigong
已援权|yiyuanquan
提了|tile
改款|gaikuan
变网商|bianwangshang
款算|kuansuan
啥时候|shashihou
大型|daxing
提不起|tibuqi
多款|duokuan
压根|yagen
元二是|yuanershi
多快|duokuai
mei|mei
拉面|lamian
补卡|buka
不让进入|burangjinru
打通|datong
会关|huiguan
海款|haikuan
尼|ni
记算|jisuan
高中|gaozhong
何用|heyong
前用|qianyong
真正|zhenzheng
有借有还|youjieyouhai
再接|zaijie
问开|wenkai
会冻解|huidongjie
票订|piaoding
日常|richang
商能|shangneng
可时|keshi
收拾|shoushi
立|li
特权|tequan
都市|dushi
什说|shenshuo
占用|zhanyong
五百四十|wubaisishi
定义|dingyi
店|dian
固额|gue
关呀|guanya
钱少|qianshao
高|gao
餐费|canfei
机号|jihao
联华|lianhua
能后|nenghou
地钱|deqian
有加|youjia
我订|woding
亮|liang
阿瑟|ase
要加|yaojia
容时|rongshi
但点|dandian
风控|fengkong
点前|dianqian
关不|guanbu
钟头|zhongtou
货到付款|huodaofukuan
因有|yinyou
升个|shengge
免息期|mianxiqi
与|yu
三千元|sanqianyuan
后宁外|houningwai
提我额|tiwoe
现象|xianxiang
卖东西|maidongxi
充分|chongfen
神州|shenzhou
算数|suanshu
通讯|tongxun
圈|quan
错点|cuodian
有预|youyu
镀额|due
中国电信|zhongguodianxin
亿|yi
外欠|waiqian
下去|xiaqu
看病|kanbing
改|gai
页面|yemian
固原市|guyuanshi
啤|pi
笔会|bihui
付宝|fubao
你声|nisheng
gd|gd
权|quan
帝|di
连本带利|lianbendaili
一共|yigong
三千块|sanqiankuai
被迫|beipo
到免|daomian
时先|shixian
增加|zengjia
日鬼会|riguihui
升不升|shengbusheng
x|x
我时|woshi
印证|yinzheng
一部分|yibufen
还歉|haiqian
变换|bianhuan
八辈子|babeizi
今用|jinyong
粉|fen
取|qu
哪些|neixie
面页|mianye
身份证|shenfenzheng
打卡|daka
看清楚|kanqingchu
后换个|houhuange
时长|shizhang
达到|dadao
一半|yiban
新疆|xinjiang
每家店|meijiadian
扣账|kouzhang
狗|gou
退往|tuiwang
来龙去脉|lailongqumai
天猫|tianmao
整么办|zhengmeban
变低|biandi
无钱|wuqian
退迟|tuichi
一点一点|yidianyidian
回|hui
改日|gairi
正常|zhengchang
偿还|changhuan
通行|tongxing
更变|gengbian
书旗|shuqi
流泪|liulei
支付方|zhifufang
洁净|jiejing
算天|suantian
这一说|zheyishuo
同一时间|tongyishijian
每鲜|meixian
我升|wosheng
没店|meidian
京东|jingdong
复件|fujian
没买用|meimaiyong
vip|vip
ie|ie
优|you
关啦|guanla
音博店|yinbodian
外部|waibu
哪些方面|neixiefangmian
二码|erma
码付|mafu
选一|xuanyi
除去|chuqu
生活圈|shenghuoquan
五六百|wuliubai
怎麼|zenme
共享|gongxiang
只差|zhicha
辛辛苦苦|xinxinkuku
贼|zei
讷|ne
凭|ping
优势|youshi
录|lu
点上|dianshang
我查|wocha
就会|jiuhui
什幺|shenyao
利高|ligao
毁约|huiyue
要解|yaojie
plus|plus
估算|gusuan
千五|qianwu
俄|e
麦|mai
规定|guiding
账前|zhangqian
一百元|yibaiyuan
台胞证|taibaozheng
钱来|qianlai
百安居|baianju
在意|zaiyi
天险|tianxian
差异|chayi
卡里|kali
查明|chaming
我误|wowu
足够|zugou
帮订|bangding
清客|qingke
喊|han
从此|congci
郎个|langge
是不是|shibushi
焦作|jiaozuo
无论|wulun
带鱼|daiyu
屡次|lvci
提过额|tiguoe
送人|songren
off|off
总有|zongyou
猫券|maoquan
钱|qian
没限|meixian
还齐|haiqi
名义|mingyi
开关|kaiguan
掌柜|zhanggui
更换|genghuan
社么降|shemejiang
显置|xianzhi
点钟|dianzhong
点餐|diancan
随身|suishen
误用|wuyong
没下|meixia
红米|hongmi
却用|queyong
老用|laoyong
添错|tiancuo
单线|danxian
没超|meichao
预订|yuding
脉|mai
搭车|dache
huankuan|huankuan
还会开|haihuikai
男人|nanren
度能|duneng
导航|daohang
银联卡|yinlianka
不慎|bushen
败|bai
回给|huigei
括号|kuohao
最起码|zuiqima
租小|zuxiao
验|yan
票|piao
喜马拉雅|ximalaya
骗局|pianju
兑|dui
改不了|gaibuliao
前|qian
三块|sankuai
没电|meidian
七|qi
药房|yaofang
会影|huiying
分比|fenbi
注册|zhuce
不仅|bujin
说了半天|shuolebantian
火锅|huoguo
方式|fangshi
mobie|mobie
缓点|huandian
叻|le
推迟|tuichi
换来换去|huanlaihuanqu
付能付|funengfu
冻解|dongjie
打进去|dajinqu
周年|zhounian
大促|dacu
分久|fenjiu
给出|geichu
一千四百|yiqiansibai
登陆密码|denglumima
无缘|wuyuan
码|ma
厚|hou
绷定|bengding
到照|daozhao
几元|jiyuan
不定|buding
觉得|juede
行业|hangye
炒股|chaogu
ixi|ixi
历史|lishi
导出|daochu
微|wei
留|liu
脸刷|lianshua
解觉|jiejue
男士|nanshi
怎向|zenxiang
改了|gaile
七点|qidian
冒|mao
封控要|fengkongyao
弄出去|nongchuqu
土沟|tugou
用姑|yonggu
你关|niguan
兆|zhao
案件|anjian
兰州|lanzhou
如过|ruguo
估评|guping
从买个|congmaige
毕竟|bijing
六点|liudian
顺便|shunbian
买|mai
不良信息|buliangxinxi
扫马|saoma
开即|kaiji
泰地|taide
白搭|baida
没进|meijin
买用|maiyong
那照|nazhao
怎会|zenhui
美且|meiqie
拉拉|lala
怎样|zenyang
93|93
提额|tie
底借|dijie
元应|yuanying
挂|gua
卓悦|zhuoyue
收活|shouhuo
最合适|zuiheshi
起款|qikuan
成功率|chenggonglv
挖有|wayou
列出来|liechulai
duo|duo
近几个月|jinjigeyue
店员|dianyuan
未确|weique
网商关|wangshangguan
执照|zhizhao
金没变|jinmeibian
额额|ee
打印|dayin
找代|zhaodai
传奇|chuanqi
这张|zhezhang
壳|ke
烟酒|yanjiu
上加|shangjia
meirangn|meirangn
救命|jiuming
天在|tianzai
结果|jieguo
全是|quanshi
时不显|shibuxian
解释|jieshi
福州|fuzhou
左上|zuoshang
定美团|dingmeituan
吵支|chaozhi
收钱码|shouqianma
草|cao
快到|kuaidao
于额宝|yuebao
查过|chaguo
眷|juan
充好|chonghao
退过款|tuiguokuan
具体步骤|jutibuzhou
发来|falai
年收入|nianshouru
从梆定|congbangding
剪|jian
一顿|yidun
日晚|riwan
现金交易|xianjinjiaoyi
再重|zaizhong
十九号|shijiuhao
款能|kuanneng
放弃|fangqi
小东西|xiaodongxi
维客|weike
粑|ba
一万八|yiwanba
一件|yijian
还花|haihua
结了|jiele
规矩|guiju
咋付|zafu
刮乐|guale
帐户|zhanghu
还青|haiqing
哈伦|halun
合伙|hehuo
每单|meidan
师傅|shifu
扣点|koudian
楚用|chuyong
加长|jiazhang
去过|quguo
减号|jianhao
单单|dandan
门票|menpiao
骑|qi
收扫|shousao
主妇|zhufu
贷款额度|daikuanedu
夜里|yeli
吻合|wenhe
那花|nahua
招商银行|zhaoshangyinhang
可改|kegai
我存|wocun
人物|renwu
包不|baobu
非|fei
有涨|youzhang
倒减|daojian
第二天|diertian
几步|jibu
s|s
涮|shuan
难|nan
蜜码|mima
缴|jiao
激活|jihuo
来充|laichong
那该|nagai
老要|laoyao
取暖费|qunuanfei
洗衣服|xiyifu
刚扣|gangkou
先下|xianxia
摁|en
开会|kaihui
咋搞|zagao
即将|jijiang
秘书|mishu
收款单|shoukuandan
管不了|guanbuliao
上解|shangjie
门|men
w|w
借点|jiedian
运费险|yunfeixian
抚州市|fuzhoushi
临时|linshi
周末|zhoumo
成功率高|chenggonglvgao
侯能|houneng
买买|maimai
十二个|shierge
进程|jincheng
荔枝|lizhi
成本|chengben
优惠券|youhuiquan
转下|zhuanxia
哪个|neige
去不去|qubuqu
逾|yu
千能|qianneng
弑神|shishen
收账|shouzhang
很差|hencha
点过|dianguo
分批|fenpi
虽要|suiyao
九百多|jiubaiduo
之后|zhihou
不输|bushu
登上|dengshang
发消息|faxiaoxi
险中|xianzhong
可通|ketong
四百|sibai
关门|guanmen
居然|juran
一有|yiyou
明调|mingdiao
方案|fangan
我小蓝车|woxiaolanche
热水器|reshuiqi
分掉|fendiao
档案|dangan
化|hua
老叫|laojiao
蚂|ma
哈罗|haluo
剩点|shengdian
几件|jijian
双休日|shuangxiuri
根据|genju
进店|jindian
几千块|jiqiankuai
方不|fangbu
花被|huabei
平凡|pingfan
188|188
段|duan
借日|jieri
里行|lixing
問問|wenwen
给|gei
清晰|qingxi
呦|you
滑板|huaban
唯一|weiyi
卡咯|kage
货运车|huoyunche
币|bi
唤|huan
海|hai
用错|yongcuo
案|an
好扣|haokou
钱出|qianchu
详细|xiangxi
订期|dingqi
手游|shouyou
和子|hezi
申請|shenqing
后|hou
发发|fafa
原本|yuanben
先息|xianxi
怎算|zensuan
无线|wuxian
美宜佳|meiyijia
机型|jixing
能点|nengdian
有利于|youliyu
日记|riji
帮不了|bangbuliao
中专|zhongzhuan
也好|yehao
乱七八糟|luanqibazao
法律承认|falvchengren
没说|meishuo
拍用|paiyong
办法|banfa
华费|huafei
所邦定|suobangding
该用|gaiyong
没往|meiwang
多发|duofa
多于|duoyu
如若|ruruo
若|ruo
収|shou
牌子|paizi
零售商|lingshoushang
帮忙|bangmang
提早|tizao
体验|tiyan
咱|zan
用到|yongdao
校|xiao
huo|huo
生产|shengchan
提示|tishi
前天|qiantian
对|dui
我解|wojie
以出|yichu
预购|yugou
购过|gouguo
优先|youxian
登记证|dengjizheng
管清|guanqing
缺什么|queshenme
用负|yongfu
代存|daicun
一摇|yiyao
老公|laogong
品牌|pinpai
选则|xuanze
那类|nalei
历史记录|lishijilu
开完|kaiwan
移除|yichu
额调|ediao
转来|zhuanlai
被|bei
真么样|zhenmeyang
发倍|fabei
行为|xingwei
已开|yikai
担心|danxin
核身|heshen
理财|licai
开开|kaikai
新建|xinjian
李|li
后金|houjin
职分|zhifen
关注|guanzhu
七八点|qibadian
没给|meigei
中是|zhongshi
制约|zhiyue
大幅度降低|dafudujiangdi
已后|yihou
发生|fasheng
我交|wojiao
少于|shaoyu
密度|midu
附海|fuhai
儿|er
欠债|qianzhai
只得|zhide
存钱|cunqian
收专享|shouzhuanxiang
电话号码|dianhuahaoma
之内|zhinei
可超|kechao
少楼|shaolou
后成|houcheng
以免|yimian
永不|yongbu
zong|zong
代为|daiwei
超现|chaoxian
清偿|qingchang
以往|yiwang
那未|nawei
整么|zhengme
气候|qihou
缴立|jiaoli
速度|sudu
黄金|huangjin
需付|xufu
哪号|nahao
组件|zujian
讲|jiang
阴魂不散|yinhunbusan
钱越|qianyue
视频|shipin
抵集|diji
图|tu
减额|jiane
差价|chajia
不能允许|bunengyunxu
消费额|xiaofeie
解决|jiejue
有何意义|youheyiyi
调|diao
要不是|yaobushi
一方|yifang
抵押金|diyajin
该款|gaikuan
销毁|xiaohui
三百块|sanbaikuai
条件|tiaojian
hahaha|hahaha
误导|wudao
打好|dahao
廷长|tingzhang
店长|dianzhang
j|j
线为|xianwei
没马|meima
我务点|wowudian
菜市场|caishichang
接收|jieshou
相互影响|xianghuyingxiang
借条|jietiao
马甲|majia
挖矿|wakuang
不长分|buzhangfen
投资|touzi
以收|yishou
购购|gougou
人日|renri
新手|xinshou
钱话|qianhua
度受|dushou
现要|xianyao
涨幅|zhangfu
调后|diaohou
穷死|qiongsi
煤费|meifei
时有分|shiyoufen
越长越|yuezhangyue
额滴|edi
近不去|jinbuqu
取不出|qubuchu
工具栏|gongjulan
我同|wotong
手段|shouduan
扣能|kouneng
具理|juli
罚息|faxi
四号|sihao
啥事|shashi
能贷|nengdai
账会|zhanghui
计划|jihua
还城|haicheng
先享后付|xianxianghoufu
交代|jiaodai
过去|guoqu
已达限|yidaxian
琢磨|zuomo
不样|buyang
会入|huiru
六号|liuhao
本次|benci
减倒|jiandao
直说|zhishuo
得升|desheng
麽|mo
三角形|sanjiaoxing
已|yi
怅单|changdan
银行担保|yinhangdanbao
期至|qizhi
扫二唯码|saoerweima
集|ji
二十五元|ershiwuyuan
密保能|mibaoneng
码要|mayao
用钱|yongqian
没发|meifa
协作|xiezuo
没提|meiti
一万两|yiwanliang
借卡|jieka
不限视|buxianshi
悦换|yuehuan
钱起|qianqi
应扣|yingkou
上报|shangbao
赢取|yingqu
停车|tingche
无印良品|wuyinliangpin
怎取销|zenquxiao
短信|duanxin
建设银行|jiansheyinhang
合约|heyue
代收|daishou
昨天夜里|zuotianyeli
幺|yao
当然|dangran
买个|maige
十年|shinian
大会|dahui
订房|dingfang
想不起来|xiangbuqilai
某收|moushou
冻上|dongshang
更快|gengkuai
上证|shangzheng
退用|tuiyong
行不行|xingbuxing
套出来|taochulai
喜洋洋|xiyangyang
叫车|jiaoche
十元|shiyuan
该是|gaishi
早|zao
码子|mazi
负是|fushi
那小蓝|naxiaolan
算加|suanjia
张红|zhanghong
行嘛|xingma
住|zhu
错误操作|cuowucaozuo
五十|wushi
款返|kuanfan
付是|fushi
两件|liangjian
家家|jiajia
没长|meizhang
只到|zhidao
分割|fenge
借记卡|jiejika
压金用|yajinyong
发不发|fabufa
173|173
全付|quanfu
出新|chuxin
能否|nengfou
鸭|ya
玛蚁|mayi
为啥|weisha
几百块|jibaikuai
报装|baozhuang
一条|yitiao
多人|duoren
磨牙|moya
出用|chuyong
扫脸|saolian
搜花|souhua
信意|xinyi
机要|jiyao
花会|huahui
营|ying
年终|nianzhong
低于|diyu
轮|lun
问算|wensuan
是非|shifei
货才|huocai
下延|xiayan
万个|wange
抵触|dichu
得用|deyong
差点|chadian
物美|wumei
不升|busheng
扯掉|chediao
可认|keren
私企|siqi
查话费|chahuafei
下会关|xiahuiguan
回款|huikuan
高速|gaosu
ios|ios
我新换|woxinhuan
相等|xiangdeng
贵|gui
还时|haishi
我能|woneng
待付|daifu
以改|yigai
何时能|heshineng
如们|rumen
新出|xinchu
刪|shan
网商款|wangshangkuan
用来|yonglai
打钱|daqian
日利|rili
奖励|jiangli
指提|zhiti
全价|quanjia
能能|nengneng
踢足球|tizuqiu
收支|shouzhi
正号|zhenghao
挣加|zhengjia
标准|biaozhun
期数|qishu
经付|jingfu
评估|pinggu
机顶盒|jidinghe
八天|batian
升为|shengwei
事能|shineng
账哈|zhangha
咋设|zashe
分款|fenkuan
智行|zhixing
怀疑|huaiyi
我妹|womei
元小蓝|yuanxiaolan
分享|fenxiang
结不起款|jiebuqikuan
来源|laiyuan
极致|jizhi
中奖|zhongjiang
家人|jiaren
低息|dixi
小黄|xiaohuang
统统|tongtong
美家|meijia
随开|suikai
四云|siyun
纬纱|weisha
涨价|zhangjia
声波|shengbo
咋关|zaguan
扫时|saoshi
还来|hailai
浴缸|yugang
分配|fenpei
接款|jiekuan
一个半|yigeban
激不活|jibuhuo
仙人跳|xianrentiao
招联里|zhaolianli
不可不|bukebu
日钱|riqian
节能|jieneng
转化成|zhuanhuacheng
其他费用|qitafeiyong
演变成|yanbiancheng
首次|shouci
三四天|sansitian
能少|nengshao
提有|tiyou
中途|zhongtu
均等|jundeng
提是|tishi
好长时间|haozhangshijian
借出|jiechu
有毒|youdu
購物|gouwu
借比|jiebi
钱花贝|qianhuabei
溢|yi
选到|xuandao
调料|tiaoliao
格|ge
车站|chezhan
一个多月|yigeduoyue
客度|kedu
还重|haizhong
信心|xinxin
如果说|ruguoshuo
天会|tianhui
克|ke
f|f
还本付息|huanbenfuxi
时辰|shichen
教我如何|jiaoworuhe
狗屁|goupi
借一仟|jieyiqian
平安夜|pinganye
界面|jiemian
自愿|ziyuan
后后|houhou
监督|jiandu
转圈圈|zhuanquanquan
以一|yiyi
俩个|liage
搭|da
饲料|siliao
多会|duohui
完年|wannian
开用|kaiyong
或换|huohuan
创建|chuangjian
抽|chou
经扣|jingkou
多买|duomai
替人|tiren
购置|gouzhi
人工|rengong
还体|haiti
不花用|buhuayong
小|xiao
现实|xianshi
享个|xiangge
万块|wankuai
两分|liangfen
好何|haohe
现卡|xianka
买方|maifang
起息|qixi
怅号|changhao
本金|benjin
一簇|yicu
曰|yue
应付款|yingfukuan
黄色|huangse
已管|yiguan
好麻|haoma
抽丝|chousi
到手|daoshou
死板|siban
定购|dinggou
张额|zhange
试用期|shiyongqi
一代|yidai
余地|yudi
售卖|shoumai
為|wei
总闪退|zongshantui
农业|nongye
v|v
想要|xiangyao
馆|guan
预留|yuliu
借不来|jiebulai
付网|fuwang
未交|weijiao
小说|xiaoshuo
菜|cai
烟草|yancao
游|you
点多成|dianduocheng
退票费|tuipiaofei
先问|xianwen
误乐|wule
还开|haikai
获取|huoqu
额外|ewai
以能|yineng
借是|jieshi
往里面|wanglimian
拣选|jianxuan
没同|meitong
最高分|zuigaofen
上边|shangbian
问能|wenneng
改为|gaiwei
定期|dingqi
开取|kaiqu
释放|shifang
平摊|pingtan
分斯|fensi
h|h
好几家|haojijia
买鞋|maixie
摇出|yaochu
挺用|tingyong
天堂|tiantang
那进|najin
关比|guanbi
六分|liufen
搁|ge
经关|jingguan
日含|rihan
充电|chongdian
购物券|gouwuquan
按摩|anmo
抽取|chouqu
力|li
违规操作|weiguicaozuo
家电|jiadian
完蛋|wandan
即刻|jike
实|shi
费及|feiji
素材|sucai
luo|luo
結清|jieqing
越短|yueduan
人口|renkou
先想|xianxiang
公章|gongzhang
性质|xingzhi
代扣|daikou
加湿器|jiashiqi
清空|qingkong
个人信息|gerenxinxi
加油|jiayou
高额|gaoe
内到|neidao
刚充|gangchong
看到|kandao
会加|huijia
补|bu
呮|qi
用快|yongkuai
会愈期|huiyuqi
代么|daime
合并|hebing
哪几个|najige
前有|qianyou
家乐福|jialefu
大哭|daku
质询|zhixun
额能|eneng
车退|chetui
百分比|baifenbi
成黑卡|chengheika
以内|yinei
收回|shouhui
本机|benji
可见|kejian
商商|shangshang
能带|nengdai
几起|jiqi
可解|kejie
欢|huan
心情|xinqing
开退|kaitui
别说|bieshuo
录入|luru
内有|neiyou
满返|manfan
期换|qihuan
一万二|yiwaner
签|qian
过别|guobie
始用|shiyong
媒体|meiti
解锁|jiesuo
第一回|diyihui
开错|kaicuo
昨天|zuotian
有开|youkai
帐子|zhangzi
开支|kaizhi
限期|xianqi
充当|chongdang
外籍|waiji
消户|xiaohu
开放式|kaifangshi
多多|duoduo
天猫购|tianmaogou
准确|zhunque
九转|jiuzhuan
老婆|laopo
甘肃|gansu
千元|qianyuan
会成|huicheng
評估|pinggu
花裁|huacai
不有|buyou
八个|bage
这样的话|zheyangdehua
龙|long
只付|zhifu
绝大部分|juedabufen
骗钱|pianqian
多么|duome
效应|xiaoying
看通|kantong
没填|meitian
只用|zhiyong
极速|jisu
冻|dong
58|58
车号|chehao
买不聊|maibuliao
扣错|koucuo
暂时性|zanshixing
消费品|xiaofeipin
另付|lingfu
无聊|wuliao
新版|xinban
要降|yaojiang
一不小心|yibuxiaoxin
那头|natou
找到|zhaodao
相当于|xiangdangyu
提后|tihou
人数|renshu
今年过年|jinnianguonian
天然气|tianranqi
我方|wofang
考核|kaohe
太长|taizhang
中国银行|zhongguoyinhang
重复|chongfu
现金支付|xianjinzhifu
现状|xianzhuang
制动|zhidong
依据|yiju
移新|yixin
口|kou
看中|kanzhong
黑客|heike
还换|haihuan
额是|eshi
就会关|jiuhuiguan
每下|meixia
　|　
到位|daowei
计息|jixi
按成|ancheng
92|92
口袋|koudai
被删|beishan
毛衣|maoyi
上算|shangsuan
不填|butian
停留|tingliu
退单|tuidan
回答|huida
两千|liangqian
抵钱|diqian
保住|baozhu
安照|anzhao
承诺函|chengnuohan
零首付|lingshoufu
还进|haijin
筘|kou
几十块|jishikuai
能全|nengquan
拆|chai
低|di
重点|zhongdian
捡|jian
差距|chaju
缺期|queqi
现金|xianjin
我待会|wodaihui
券未|quanwei
往进|wangjin
帐卓|zhangzhuo
它会|tahui
放过来|fangguolai
可能性|kenengxing
我来|wolai
之有|zhiyou
哥们|gemen
随后|suihou
持续|chixu
太旺|taiwang
存不上|cunbushang
款款|kuankuan
说断|shuoduan
老说|laoshuo
午|wu
升通|shengtong
有无|youwu
缺少|queshao
可惜|kexi
b|b
进不来|jinbulai
点错|diancuo
会减|huijian
两张|liangzhang
轮子|lunzi
哪发|nafa
合|he
迅速|xunsu
发红包|fahongbao
额宝内|ebaonei
全|quan
里会|lihui
东面|dongmian
红用|hongyong
美团网|meituanwang
方付|fangfu
充|chong
失踪|shizong
不用|buyong
考评|kaoping
天弘|tianhong
分特|fente
超市|chaoshi
天荒|tianhuang
算起|suanqi
快点|kuaidian
所读|suodu
期贷|qidai
主要|zhuyao
挺|ting
可免|kemian
服务商|fuwushang
描|miao
卸载|xiezai
kfc|kfc
倍率|beilv
反正|fanzheng
正规|zhenggui
动弹|dongtan
出行|chuxing
保险|baoxian
好慢|haoman
原定|yuanding
改动|gaidong
钱点|qiandian
详情|xiangqing
不为|buwei
入网|ruwang
咋噶办|zagaban
几块钱|jikuaiqian
基础|jichu
抬头|taitou
选呀|xuanya
两百块|liangbaikuai
核查|hezha
怎有|zenyou
千了|qianle
忘记|wangji
年限|nianxian
生活馆|shenghuoguan
相关|xiangguan
五六个|wuliuge
约期|yueqi
添|tian
随借|suijie
个人帐户|gerenzhanghu
134|134
申述|shenshu
租赁|zulin
找点|zhaodian
镜|jing
失误|shiwu
时天|shitian
合理|heli
过来|guolai
准时|zhunshi
能代|nengdai
昌|chang
六期|liuqi
求升|qiusheng
一小部分|yixiaobufen
五月份|wuyuefen
以未|yiwei
首笔|shoubi
放假|fangjia
刮刮卡|guaguaka
花臂|huabi
东莞|dongguan
个人信用|gerenxinyong
各位|gewei
带来|dailai
卸载掉|xiezaidiao
发手机|fashouji
错号|cuohao
否清|fouqing
日卡上|rikashang
皆|jie
有交|youjiao
空扣|kongkou
授权书|shouquanshu
元月|yuanyue
交纳|jiaona
茶苑|chayuan
首款|shoukuan
会员名|huiyuanming
基本|jiben
邮政|youzheng
还会用|haihuiyong
只不过|zhibuguo
转走|zhuanzou
粤宝|yuebao
嚒|me
要收|yaoshou
飞天|feitian
二十天|ershitian
pos|pos
纹身|wenshen
会员|huiyuan
打滴|dadi
反利|fanli
能用|nengyong
什麼|shenme
账本|zhangben
乘|cheng
领到|lingdao
只分|zhifen
乘车码|chengchema
看不起|kanbuqi
让开|rangkai
糯米|nuomi
小密|xiaomi
出示|chushi
城市|chengshi
认不出|renbuchu
网络|wangluo
算了|suanle
抵押借款|diyajiekuan
银行借款|yinhangjiekuan
几比|jibi
不正|buzheng
就是指|jiushizhi
引起|yinqi
现都|xiandou
天嘛|tianma
用里|yongli
购了|goule
福彩|fucai
股东|gudong
不道|budao
测试|ceshi
餐|can
在外|zaiwai
最后|zuihou
唯品|weipin
烟|yan
购物|gouwu
分其|fenqi
拿不出|nabuchu
每借|meijie
延|yan
feichang|feichang
显示信息|xianshixinxi
公用事业|gongyongshiye
坏|huai
多正能|duozhengneng
冯|feng
出租|chuzu
诚信|chengxin
度错|ducuo
物件|wujian
纸巾|zhijin
只会|zhihui
红旗|hongqi
还用|haiyong
成复|chengfu
营业执照|yingyezhizhao
白金|baijin
白天|baitian
不合|buhe
着实|zheshi
影子|yingzi
同月|tongyue
悬殊|xuanshu
没涨|meizhang
点不出|dianbuchu
正反两面|zhengfanliangmian
报停|baoting
操作|caozuo
假货|jiahuo
九点|jiudian
低点|didian
廷后|tinghou
不能变更|bunengbiangeng
花背|huabei
后整|houzheng
每年|meinian
有种|youzhong
购的物|goudewu
还会收|haihuishou
结束|jieshu
玛|ma
八折|bazhe
额外收费|ewaishoufei
那能|naneng
换掉|huandiao
会高|huigao
城乡|chengxiang
邦|bang
kai|kai
数学|shuxue
什过|shenguo
可挺|keting
进到|jindao
地点|didian
眨眼睛|zhayanjing
钟期|zhongqi
人下|renxia
不全|buquan
邀|yao
稳赚|wenzhuan
他们|tamen
进不去|jinbuqu
单都|dandou
刚下|gangxia
到斯|daosi
评比|pingbi
预定|yuding
完帮|wanbang
降为|jiangwei
一分钱|yifenqian
二三十万|ersanshiwan
实店|shidian
咋查|zacha
教教|jiaojiao
但通|dantong
租令|zuling
这块|zhekuai
mall|mall
已放|yifang
司机|siji
关要|guanyao
客气|keqi
刚借|gangjie
上周|shangzhou
锅上|guoshang
涨到|zhangdao
乱|luan
五星|wuxing
协议|xieyi
怀柔|huairou
哪样|nayang
但度|dandu
后关|houguan
遇留|yuliu
动用|dongyong
人行|renxing
多算|duosuan
叫外卖|jiaowaimai
没取|meiqu
停用|tingyong
扣费会|koufeihui
会消|huixiao
百度|baidu
取不来|qubulai
加何|jiahe
我院|woyuan
apples|apples
会员中心|huiyuanzhongxin
两款|liangkuan
最高额|zuigaoe
店要|dianyao
解权|jiequan
具体操作|juticaozuo
共用|gongyong
找个|zhaoge
做些|zuoxie
突发|tufa
反问|fanwen
换取|huanqu
户端|huduan
余额宝|yuebao
笔买|bimai
状况|zhuangkuang
要分|yaofen
让我拿|rangwona
查以|chayi
倒闭|daobi
总资产|zongzichan
网商貸|wangshangdai
我晕|woyun
飞车|feiche
记不清|jibuqing
剑网|jianwang
凯奇|kaiqi
私人|siren
乱点|luandian
情绪|qingxu
识别|shibie
完车|wanche
关于|guanyu
小于|xiaoyu
乐购|legou
仍然|rengran
昱|yu
那退|natui
衫|shan
先扣|xiankou
礼物|liwu
咋成|zacheng
申领|shenling
损失|sunshi
老兄|laoxiong
数字|shuzi
我补|wobu
拆除|chaichu
九日|jiuri
送餐|songcan
中旬|zhongxun
说实话|shuoshihua
推回来|tuihuilai
不断|buduan
改不掉|gaibudiao
能缴|nengjiao
盖|gai
奇怪的是|qiguaideshi
安全|anquan
空款|kongkuan
天才|tiancai
龙江|longjiang
这哈|zheha
蹲|dun
多重|duozhong
过于|guoyu
游戏类|youxilei
用花贝|yonghuabei
雨|yu
内|nei
分|fen
经额|jinge
pay|pay
按理说|anlishuo
加着|jiazhe
算了吧|suanleba
判断|panduan
工能|gongneng
收年费|shounianfei
字母|zimu
账错|zhangcuo
万六|wanliu
购物广场|gouwuguangchang
支付现金|zhifuxianjin
飞|fei
购物款|gouwukuan
星期天|xingqitian
方或式|fanghuoshi
赠品|zengpin
清款|qingkuan
以九|yijiu
热点问题|redianwenti
长期借款|changqijiekuan
他换|tahuan
培训|peixun
八百多|babaiduo
滴钱|diqian
我哥|woge
教育|jiaoyu
绿岛|lvdao
过路费|guolufei
杭州市|hangzhoushi
扫不出|saobuchu
公交车|gongjiaoche
货有|huoyou
下调|xiadiao
十九点|shijiudian
调额额|diaoee
跳动|tiaodong
饿|e
金变|jinbian
刚转|gangzhuan
可欲借|keyujie
减掉|jiandiao
借着|jiezhe
筠连|yunlian
动|dong
这一|zheyi
借不鸟|jiebuniao
鞋店|xiedian
打算|dasuan
元到|yuandao
不上|bushang
還款|haikuan
岀|chu
疑义|yiyi
二千|erqian
成长|chengzhang
明说|mingshuo
提过|tiguo
区|qu
在生活中|zaishenghuozhong
人能|renneng
定向|dingxiang
开机|kaiji
务|wu
四千元|siqianyuan
册除|cechu
餐厅|canting
自降|zijiang
46|46
啥样|shayang
花吹|huachui
滞后|zhihou
厂家|changjia
账内|zhangnei
标栏|biaolan
今月|jinyue
刷大|shuada
收不款|shoubukuan
重心|zhongxin
莉|li
结冻|jiedong
卷到|juandao
全福|quanfu
星|xing
一哈嘛|yihama
粘网|zhanwang
叫做|jiaozuo
食用|shiyong
天免|tianmian
中租|zhongzu
快乐|kuaile
以百为|yibaiwei
挺前|tingqian
萌妹|mengmei
预支|yuzhi
怎杞|zenqi
美团订|meituanding
起|qi
扣嘛|kouma
推向|tuixiang
柠檬|ningmeng
扩大|kuoda
卡号|kahao
先抵|xiandi
反悔|fanhui
唄交暖|beijiaonuan
欧洲|ouzhou
负约|fuyue
已收|yishou
逾额|yue
栏里|lanli
一块|yikuai
放着|fangzhe
没弄|meinong
包|bao
退费|tuifei
柜台|guitai
针对|zhendui
超扣|chaokou
姐|jie
赔|pei
总计|zongji
利能|lineng
续期|xuqi
紧张|jinzhang
快车|kuaiche
改卡|gaika
我试|woshi
固定额|gudinge
提高|tigao
感兴趣|ganxingqu
战对|zhandui
标示|biaoshi
弄回|nonghui
两三个|liangsange
时扣|shikou
布|bu
@|@
程度|chengdu
七号|qihao
怎不长|zenbuzhang
借请|jieqing
减伤|jianshang
市场价|shichangjia
可到|kedao
机用|jiyong
钱升|qiansheng
签写|qianxie
用扣|yongkou
节省|jiesheng
百花|baihua
失联|shilian
请登入|qingdengru
不知去向|buzhiquxiang
陶宝|taobao
大人|daren
有什|youshen
订美团|dingmeituan
止付|zhifu
医保|yibao
表|biao
关不掉|guanbudiao
东|dong
二十二|ershier
无用|wuyong
明天|mingtian
里面|limian
扣费|koufei
我机|woji
周五|zhouwu
客户端|kehuduan
模板|muban
不收|bushou
凊|qing
有限公司|youxiangongsi
多块|duokuai
全新|quanxin
算入|suanru
下不上|xiabushang
遇到困难|yudaokunnan
不老|bulao
九游|jiuyou
点入|dianru
有待|youdai
订过|dingguo
分別|fenbie
热风|refeng
提临额|tiline
九十天|jiushitian
刚领|gangling
充话|chonghua
充扣币|chongkoubi
那去|naqu
咋算|zasuan
删处|shanchu
清|qing
本店|bendian
何|he
一气之下|yiqizhixia
您们|ninmen
资费|zifei
分要|fenyao
多能|duoneng
灵活|linghuo
制服|zhifu
更长|gengzhang
只选|zhixuan
二百三十多|erbaisanshiduo
钱改|qiangai
九天|jiutian
付减|fujian
头用|touyong
到货|daohuo
apss|apss
一百多天|yibaiduotian
农信社|nongxinshe
慢是|manshi
缩小|suoxiao
用于|yongyu
扫完|saowan
那开|nakai
返是|fanshi
陪款|peikuan
付完|fuwan
两回|lianghui
发生冲突|fashengchongtu
上面|shangmian
用途|yongtu
定单|dingdan
帮情|bangqing
已销|yixiao
冻节|dongjie
买手机|maishouji
能行|nengxing
胃|wei
四位|siwei
进取|jinqu
觉|jue
取钱|quqian
扫描器|saomiaoqi
时选|shixuan
遇见|yujian
领钱|lingqian
鬼呀|guiya
份|fen
缓冲期|huanchongqi
新户|xinhu
一到|yidao
月数|yueshu
以上|yishang
一键|yijian
解除限制|jiechuxianzhi
有关|youguan
解借|jiejie
多长|duozhang
分账|fenzhang
怎心|zenxin
蚂衣花|mayihua
付款单|fukuandan
年三十|niansanshi
水|shui
弄个|nongge
百分|baifen
补救措施|bujiucuoshi
哪边|nabian
有人|youren
老是|laoshi
网商化|wangshanghua
维码|weima
老板|laoban
提示信息|tishixinxi
天没到|tianmeidao
额咯|ege
快通|kuaitong
辛苦|xinku
我歉|woqian
说款|shuokuan
换清|huanqing
用花唄|yonghuabei
分不涨|fenbuzhang
免|mian
新车|xinche
完回|wanhui
时是|shishi
花分|huafen
失信|shixin
保险费|baoxianfei
dnf|dnf
房贷|fangdai
元月份|yuanyuefen
实行|shixing
拉|la
俺|an
花光|huaguang
弄|nong
今日|jinri
辣|la
间少|jianshao
升过|shengguo
期月|qiyue
手续费收|shouxufeishou
连字|lianzi
俄罗斯|eluosi
社保卡|shebaoka
七十九|qishijiu
长些|zhangxie
嫌额|xiane
查讯|chaxun
付支|fuzhi
转绑|zhuanbang
不要紧|buyaojin
安卓转|anzhuozhuan
八万|bawan
授予|shouyu
原有|yuanyou
转换|zhuanhuan
对不起|duibuqi
主号|zhuhao
柬埔寨|jianpuzhai
手机游戏|shoujiyouxi
赠券|zengquan
万|wan
不款|bukuan
解开|jiekai
惩罚|chengfa
圆通|yuantong
152|152
面付|mianfu
生日|shengri
个人主页|gerenzhuye
代充|daichong
我想問|woxiangwen
分析|fenxi
以扣|yikou
时段|shiduan
关了|guanle
时先用|shixianyong
摇到|yaodao
一想|yixiang
33|33
二|er
开借|kaijie
信用度|xinyongdu
马眼|mayan
我肯|woken
酷狗|kugou
几期|jiqi
没算到|meisuandao
依然|yiran
超时|chaoshi
延时|yanshi
进度|jindu
梦用|mengyong
来来|lailai
交换|jiaohuan
说关|shuoguan
转卖|zhuanmai
哪用|nayong
个会|gehui
数|shu
息|xi
产正错|chanzhengcuo
他人|taren
极少|jishao
次信|cixin
交易|jiaoyi
老提|laoti
分上|fenshang
细|xi
期后|qihou
再发|zaifa
支护|zhihu
文|wen
好几十|haojishi
不比|bubi
长点|zhangdian
10|10
农|nong
退不退|tuibutui
速|su
十月|shiyue
分涨|fenzhang
一拦|yilan
权益|quanyi
一个个|yigege
摸输错|moshucuo
总要|zongyao
支微信|zhiweixin
那钱|naqian
笔记|biji
不记|buji
划扣|huakou
衬衫|chenshan
没什么|meishenme
号|hao
早点|zaodian
请|qing
方便|fangbian
执行|zhixing
滑|hua
重新|chongxin
外卖|waimai
我刚|wogang
借额|jiee
六仟|liuqian
95|95
都|dou
小蚂答|xiaomada
已用额|yiyonge
按计划|anjihua
十五块|shiwukuai
去還|quhai
度假|dujia
开痛|kaitong
每人|meiren
向|xiang
会反|huifan
passo|passo
记错|jicuo
笔有|biyou
反照|fanzhao
九月|jiuyue
真能|zhenneng
ssss|ssss
姐姐|jiejie
alin|alin
拨|bo
用主|yongzhu
怎开|zenkai
无车|wuche
可换|kehuan
乐换|lehuan
广东|guangdong
干零|ganling
二度|erdu
pass|pass
不欠|buqian
免输|mianshu
透支|touzhi
计算器|jisuanqi
一次|yici
十八|shiba
随机|suiji
还花贝|haihuabei
一并|yibing
利是|lishi
买断|maiduan
声音|shengyin
他|ta
很烦|henfan
账能|zhangneng
代练店|dailiandian
国家|guojia
交了|jiaole
三号|sanhao
还息会|haixihui
两条|liangtiao
充真|chongzhen
纯白|chunbai
田森|tiansen
额定|eding
已否|yifou
我入|woru
价位|jiawei
负债率|fuzhailv
易网|yiwang
上次|shangci
分钱|fenqian
哪传|nachuan
一千|yiqian
∩|∩
办好|banhao
轲|ke
是否是|shifoushi
丕|pi
配偶|peiou
梦幻|menghuan
抢|qiang
我错|wocuo
我母|womu
用久|yongjiu
输不上|shubushang
迅录|xunlu
帐点|zhangdian
羽绒服|yurongfu
从账|congzhang
这月|zheyue
点后|dianhou
而天|ertian
只扣|zhikou
按月算|anyuesuan
没掉|meidiao
卡费|kafei
没帮卡|meibangka
三万|sanwan
土耳其|tuerqi
分之几|fenzhiji
合体|heti
赞同|zantong
元|yuan
中应|zhongying
扣处|kouchu
允值|yunzhi
上升|shangsheng
没读|meidu
若想|ruoxiang
11|11
奖品|jiangpin
没领|meiling
额金|ejin
不一制|buyizhi
十多|shiduo
需不需要|xubuxuyao
访问|fangwen
故障|guzhang
问匙|wenshi
上结|shangjie
时送|shisong
桃子|taozi
完琪|wanqi
代|dai
热线|rexian
洗衣|xiyi
干扰|ganrao
几|ji
存在|cunzai
没发用|meifayong
可付|kefu
银联|yinlian
外面|waimian
不嘛|buma
咱不说|zanbushuo
生成|shengcheng
提加|tijia
送给|songgei
管款|guankuan
万多|wanduo
查来查|chalaicha
蚂蚊|mawen
四次|sici
返佣|fanyong
油|you
变化|bianhua
天行|tianxing
守护|shouhu
能集|nengji
次日|ciri
尾数|weishu
携程|xiecheng
东结|dongjie
分超|fenchao
完换|wanhuan
弊端|biduan
扫描枪|saomiaoqiang
充直|chongzhi
只有|zhiyou
软能|ruanneng
响应|xiangying
再出|zaichu
钥匙|yaoshi
负多|fuduo
买充|maichong
买动|maidong
迁|qian
销|xiao
直到|zhidao
调整|tiaozheng
预存|yucun
对面|duimian
算一天|suanyitian
参加|canjia
捆起来|kunqilai
白屏|baiping
不租|buzu
整天|zhengtian
产品价格|chanpinjiage
常用|changyong
要来|yaolai
优品|youpin
后要|houyao
发送到|fasongdao
之麻|zhima
我人|woren
贴码|tiema
半年前|bannianqian
可倩|keqian
面容|mianrong
严选|yanxuan
花该|huagai
版本|banben
充足|chongzu
人交|renjiao
有限|youxian
开具|kaiju
上扣|shangkou
账务|zhangwu
框里|kuangli
有办|youban
期额|qie
直接|zhijie
满到|mandao
复合|fuhe
不良行为|buliangxingwei
要设|yaoshe
整笔|zhengbi
金融|jinrong
货|huo
豆|dou
能比|nengbi
为止|weizhi
三万多|sanwanduo
进口|jinkou
自扣|zikou
对外|duiwai
花闭|huabi
调用|diaoyong
不上生|bushangsheng
网商能|wangshangneng
配套|peitao
款式|kuanshi
遇后|yuhou
交钱|jiaoqian
双十|shuangshi
分不长|fenbuzhang
转盘|zhuanpan
马来西亚|malaixiya
归|gui
我店|wodian
打折|dazhe
了解|liaojie
撤诉|chesu
点能|dianneng
五十块|wushikuai
mobike|mobike
资质|zizhi
六块钱|liukuaiqian
登错|dengcuo
万四|wansi
白条|baitiao
第一步|diyibu
迟个|chige
乡镇|xiangzhen
学历证书|xuelizhengshu
数高|shugao
好几年|haojinian
用够|yonggou
黑|hei
欠多|qianduo
日本|riben
回新|huixin
尽然|jinran
此单|cidan
高中毕业|gaozhongbiye
祥宝儿|xiangbaoer
减扣|jiankou
一批|yipi
知道|zhidao
拒收|jushou
优先选择|youxianxuanze
开网|kaiwang
电话|dianhua
付费|fufei
喃|nan
无证|wuzheng
差别|chabie
小生意|xiaoshengyi
十五|shiwu
借|jie
aa|aa
能换个|nenghuange
框框|kuangkuang
杂找|zazhao
应换|yinghuan
取销|quxiao
经转|jingzhuan
可找|kezhao
单上|danshang
作业|zuoye
两万多|liangwanduo
是从|shicong
那来|nalai
强制|qiangzhi
头后|touhou
一倍|yibei
提分|tifen
来得|laide
还会涨|haihuizhang
撸|lu
低开|dikai
有效期|youxiaoqi
计|ji
填不上|tianbushang
额贷|edai
成负会|chengfuhui
我头|wotou
债务|zhaiwu
现场|xianchang
点券|dianquan
好看|haokan
报废|baofei
侍|shi
小费|xiaofei
客户|kehu
门店|mendian
修车|xiuche
上用|shangyong
不太懂|butaidong
支是|zhishi
公积金|gongjijin
要大余|yaodayu
非常|feichang
里取|liqu
事退|shitui
提神|tishen
收嘛|shouma
快币|kuaibi
远方|yuanfang
十多天|shiduotian
不敢|bugan
马蚁|mayi
kanbuda|kanbuda
汇花|huihua
购得|goude
款度|kuandu
信育|xinyu
便民|bianmin
怎看|zenkan
指点|zhidian
huan|huan
日为|riwei
一要|yiyao
电信卡|dianxinka
可扫|kesao
麻|ma
能换|nenghuan
元有|yuanyou
最是|zuishi
书上|shushang
m|m
己|ji
流程|liucheng
我多会|woduohui
行都|xingdu
feng|feng
广发卡|guangfaqia
报名费|baomingfei
专属|zhuanshu
上方|shangfang
乐天|letian
打上|dashang
掉下去|diaoxiaqu
知用|zhiyong
登|deng
那条|natiao
03|03
ang|ang
主动|zhudong
八九千|bajiuqian
变分|bianfen
下周一|xiazhouyi
进餐|jincan
尺寸|chicun
有门头|youmentou
有没有|youmeiyou
越欠|yueqian
写成|xiecheng
带章|daizhang
推广|tuiguang
再度|zaidu
俞期|yuqi
类人|leiren
便利|bianli
标志|biaozhi
里用|liyong
展示|zhanshi
用人|yongren
家装|jiazhuang
一下子|yixiazi
充到|chongdao
低会|dihui
定|ding
自然|ziran
一支|yizhi
不增|buzeng
发代|fadai
受理|shouli
货里|huoli
不管怎么|buguanzenme
辨认|bianren
那样|nayang
一个天|yigetian
宣掉|xuandiao
我差|wocha
吊销|diaoxiao
身分证|shenfenzheng
付会收|fuhuishou
就医|jiuyi
因是|yinshi
自身|zishen
界定|jieding
一部分一部分|yibufenyibufen
算上|suanshang
七千块|qiqiankuai
美衣|meiyi
胆是|danshi
合用|heyong
五块|wukuai
股份|gufen
完清后|wanqinghou
文付|wenfu
卖烟|maiyan
剪掉|jiandiao
对下|duixia
解决不了|jiejuebuliao
哪种|nazhong
直付|zhifu
将会|jianghui
交易方式|jiaoyifangshi
比例|bili
页|ye
里付|lifu
时时|shishi
达标|dabiao
要录|yaolu
小篮|xiaolan
卫生|weisheng
刷不出|shuabuchu
花王|huawang
未有|weiyou
后应|houying
死|si
海底|haidi
恭喜|gongxi
款用|kuanyong
金額|jine
多件|duojian
不良影响|buliangyingxiang
最好|zuihao
您|nin
机|ji
不得了|budele
∵|∵
指示|zhishi
被别|beibie
三十多块|sanshiduokuai
怎从|zencong
超出|chaochu
上千|shangqian
坑人|kengren
内必|neibi
没费|meifei
hai|hai
废话|feihua
入何|ruhe
六百|liubai
能升|nengsheng
当月份|dangyuefen
报算|baosuan
29|29
丽|li
球|qiu
借唄|jiebei
却付|quefu
分区|fenqu
开辟|kaipi
面|mian
减去|jianqu
会路|huilu
酒店宾馆|jiudianbinguan
蚂仪|mayi
能发|nengfa
但收|danshou
亊|shi
受限制|shouxianzhi
喻期|yuqi
十次|shici
大悦|dayue
过生日|guoshengri
高不高|gaobugao
我己|woji
名单|mingdan
上架|shangjia
远音|yuanyin
时间延迟|shijianyanchi
有来|youlai
花|hua
字眼|ziyan
密麻|mima
如家订|rujiading
返款|fankuan
下要|xiayao
总在|zongzai
没分|meifen
礼拜二|libaier
点钱|dianqian
变利店|bianlidian
几年|jinian
网买|wangmai
新加坡|xinjiapo
要求|yaoqiu
几扣|jikou
 | 
卡都会|kadouhui
久用|jiuyong
期嘛|qima
天算|tiansuan
流氓|liumang
德庄|dezhuang
一码|yima
什人|shenren
调回来|diaohuilai
淘气|taoqi
借付|jiefu
过大|guoda
帮上|bangshang
价值|jiazhi
冲值|chongzhi
一比|yibi
没过|moguo
永久|yongjiu
借俩|jielia
反现|fanxian
稍微|shaowei
过年|guonian
领没领|lingmeiling
显示器|xianshiqi
整过|zhengguo
付充|fuchong
为换|weihuan
到处|daochu
oppo|oppo
承担|chengdan
我该|wogai
钱下|qianxia
额度|edu
买不起|maibuqi
西游|xiyou
对换|duihuan
能当|nengdang
钱要|qianyao
我想花|woxianghua
有变|youbian
itunes|itunes
地|de
日期|riqi
老刷|laoshua
花唄|huabei
情祝|qingzhu
钱交|qianjiao
做|zuo
那日|nari
可不是|kebushi
昨天晚上|zuotianwanshang
一下子把|yixiaziba
连带|liandai
粗鲁|culu
线上|xianshang
养到|yangdao
钱办|qianban
八点|badian
年利率|nianlilv
不扫教|busaojiao
下|xia
退下|tuixia
绊定|banding
农信卡|nongxinka
还喃|hainan
发错|facuo
订阅|dingyue
信用社|xinyongshe
煤能|meineng
小幅度|xiaofudu
俩|lia
银行账号|yinhangzhanghao
两百|liangbai
在家|zaijia
借代|jiedai
四十四|sishisi
理性|lixing
51|51
福利|fuli
笔钱|biqian
不能不要|bunengbuyao
买帐|maizhang
经营性|jingyingxing
已选|yixuan
养|yang
须要|xuyao
接触|jiechu
最多负|zuiduofu
安全系数|anquanxishu
一阵子|yizhenzi
八九十|bajiushi
那用|nayong
少额|shaoe
只花|zhihua
软件|ruanjian
如此|ruci
全国|quanguo
守次|shouci
相|xiang
分年|fennian
两字|liangzi
键|jian
可信度|kexindu
一份|yifen
我延|woyan
玩过|wanguo
六七个|liuqige
全选|quanxuan
通高|tonggao
增值|zengzhi
后果自负|houguozifu
过度|guodu
买房子|maifangzi
应|ying
生|sheng
检|jian
志志玲|zhizhiling
索要|suoyao
期才|qicai
项目|xiangmu
咸少|xianshao
份够|fengou
十五日|shiwuri
建话|jianhua
磕|ke
住房贷款|zhufangdaikuan
一块钱|yikuaiqian
代钱|daiqian
中国|zhongguo
我嗦|wosuo
我询|woxun
挣求|zhengqiu
脸才行|liancaixing
解挂|jiegua
换个|huange
款退|kuantui
自已|ziyi
厂商|changshang
三单|sandan
便利店|bianlidian
刷用|shuayong
日算|risuan
先用|xianyong
石油|shiyou
所谓|suowei
乘车|chengche
后新开|houxinkai
欧亚|ouya
bunengyongle|bunengyongle
屁话|pihua
无限|wuxian
不说|bushuo
包年|baonian
好用|haoyong
减券|jianquan
降息|jiangxi
再天|zaitian
度会|duhui
该商|gaishang
扣费扣|koufeikou
领时|lingshi
张|zhang
匿名|niming
十分钟|shifenzhong
最短|zuiduan
用卡付|yongkafu
定票|dingpiao
免单|miandan
糖巢|tangchao
安其|anqi
放贷|fangdai
用集|yongji
降底|jiangdi
会移|huiyi
几万块|jiwankuai
可批|kepi
免额|miane
麦克风|maikefeng
已出|yichu
恶毒|edu
欠下|qianxia
情|qing
当做|dangzuo
想查|xiangcha
支付款|zhifukuan
还会交|haihuijiao
推出|tuichu
拘留所|juliusuo
有折|youzhe
这会|zhehui
范围|fanwei
这月用|zheyueyong
负支产|fuzhichan
电信宽带|dianxinkuandai
到哪去|daonaqu
秘密|mimi
护肤品|hufupin
一免|yimian
信里|xinli
降下来|jiangxialai
第三期|disanqi
贴|tie
你面|nimian
我想设|woxiangshe
在乎|zaihu
老闪退|laoshantui
借款|jiekuan
暂无|zanwu
客人|keren
海南|hainan
方面|fangmian
单件|danjian
逾后|yuhou
能过|nengguo
少期|shaoqi
冷结|lengjie
调试|tiaoshi
发|fa
双面|shuangmian
提不起来|tibuqilai
及来|jilai
租借|zujie
背景|beijing
调小|diaoxiao
打入|daru
礼包|libao
加分|jiafen
看吧|kanba
出国|chuguo
先点|xiandian
appstore|appstore
没满|meiman
费在|feizai
体验版|tiyanban
跨店|kuadian
巴|ba
发贝|fabei
里充|lichong
扫好|saohao
能邦|nengbang
炒股票|chaogupiao
下下个月|xiaxiageyue
看烦|kanfan
零用钱|lingyongqian
花貝|huabei
元后|yuanhou
订外|dingwai
挷|peng
还茨|haici
西|xi
我卡掉|wokadiao
钻石|zuanshi
续付|xufu
看得见|kandejian
杂接|zajie
烤饭|kaofan
甚么|shenme
兩年|liangnian
上函|shanghan
四五天|siwutian
驶用|shiyong
授信额度|shouxinedu
好端端|haoduanduan
很大|henda
上涨|shangzhang
借闭|jiebi
淘|tao
中有|zhongyou
补拍|bupai
花茶|huacha
挖|wa
抵消|dixiao
换借|huanjie
分额|fene
丢有|diuyou
两笔|liangbi
什么样|shenmeyang
铲子|chanzi
充不|chongbu
这份|zhefen
不长|buzhang
计算|jisuan
把关|baguan
次|ci
本合同|benhetong
技术|jishu
取现|quxian
明细单|mingxidan
下过|xiaguo
孒|jue
潜在|qianzai
久会|jiuhui
房车|fangche
考拉|kaola
不耍|bushua
放置不用|fangzhibuyong
大不了|dabuliao
套书|taoshu
色|se
百左右|baizuoyou
尽情|jinqing
加强|jiaqiang
刚弄|gangnong
起始值|qishizhi
个人资料|gerenziliao
回乡证|huixiangzheng
时钱|shiqian
中用|zhongyong
充着|chongzhe
罐头|guantou
降级|jiangji
这么回事|zhemehuishi
完后|wanhou
高点|gaodian
旗舰店|qijiandian
扣取|kouqu
使用不当|shiyongbudang
符合规定|fuheguiding
怎抵|zendi
余款|yukuan
嘀嘀|didi
局限|juxian
工商|gongshang
照对|zhaodui
七十多|qishiduo
登陆|denglu
取票|qupiao
单个|dange
空中|kongzhong
懂得|dongde
下账|xiazhang
有近|youjin
错款|cuokuan
累|lei
別人用|bierenyong
付过款|fuguokuan
有权|youquan
浓|nong
一二|yier
登不起|dengbuqi
n|n
值要|zhiyao
放在|fangzai
迟点|chidian
几千元|jiqianyuan
找小二|zhaoxiaoer
乱发|luanfa
前线|qianxian
评判|pingpan
wori|wori
罚款|fakuan
靠|kao
想个办法|xianggebanfa
提提|titi
省内|shengnei
查到|chadao
得知|dezhi
个别|gebie
多划|duohua
透透|toutou
退后|tuihou
能加|nengjia
回原|huiyuan
昰|shi
主|zhu
下会降|xiahuijiang
出开|chukai
管家|guanjia
例如|liru
查清|chaqing
没网|meiwang
sdk|sdk
相邻|xianglin
饮品|yinpin
符合要求|fuheyaoqiu
余期|yuqi
关闲|guanxian
铁路|tielu
财产|caichan
抵押|diya
历|li
究竟|jiujing
由于|youyu
开发票|kaifapiao
太太|taitai
能续|nengxu
客房|kefang
有高有低|yougaoyoudi
來|lai
期间|qijian
周黑|zhouhei
开成|kaicheng
一买|yimai
用个|yongge
再用|zaiyong
为期|weiqi
换到|huandao
個|ge
单子|danzi
要照|yaozhao
更用|gengyong
充钱|chongqian
昨|zuo
会上|huishang
十个|shige
张单|zhangdan
本利|benli
能密付|nengmifu
收款人|shoukuanren
转款|zhuankuan
要存|yaocun
个长|gezhang
无理|wuli
y|y
高铁|gaotie
总|zong
上买个|shangmaige
钱全|qianquan
现需|xianxu
填错|tiancuo
低成|dicheng
威逼|weibi
大|da
下才|xiacai
我花唄|wohuabei
妈|ma
密|mi
卡|ka
冻传|dongchuan
到头|daotou
这号|zhehao
原谅|yuanliang
我实|woshi
啥子|shazi
上过|shangguo
醉|zui
上班|shangban
二十万|ershiwan
老弟|laodi
帮帮我|bangbangwo
用收|yongshou
止|zhi
现时|xianshi
指出|zhichu
八百块|babaikuai
百分之一|baifenzhiyi
废弃|feiqi
查迅|chaxun
完善|wanshan
想开|xiangkai
不合算|buhesuan
咸鱼|xianyu
间成|jiancheng
协助|xiezhu
付款条件|fukuantiaojian
卡已|kayi
电击|dianji
转钱进|zhuanqianjin
缩短|suoduan
自转|zizhuan
混到|hundao
这家|zhejia
行代|xingdai
哪笔|nabi
马上|mashang
交小蓝车|jiaoxiaolanche
分率|fenlv
取退|qutui
ren|ren
晕倒|yundao
笔记本电脑|bijibendiannao
拖后|tuohou
一用|yiyong
开到|kaidao
借要|jieyao
可原|keyuan
二号|erhao
anniu|anniu
钱充|qianchong
再缓|zaihuan
玉玉|yuyu
酒吧|jiuba
完嘛|wanma
账面|zhangmian
卫衣|weiyi
就长|jiuzhang
起始|qishi
钱时|qianshi
来定|laiding
奖券|jiangquan
脖|bo
信卡|xinka
洗|xi
届|jie
吖|ya
关停|guanting
太假|taijia
期买个|qimaige
识脸|shilian
ａ|ａ
坐牢|zuolao
列王|liewang
六十多|liushiduo
灰色|huise
有事|youshi
卜|bo
比如说|birushuo
多会儿|duohuier
天会涨|tianhuizhang
推到|tuidao
未|wei
换回|huanhui
申级|shenji
款交|kuanjiao
脸|lian
银泰包|yintaibao
可信|kexin
入账|ruzhang
骑小|qixiao
钱能点|qiannengdian
咯款|gekuan
会灰服|huihuifu
这起|zheqi
往|wang
中百|zhongbai
莫城易|mochengyi
时侯|shihou
先帮|xianbang
分月出|fenyuechu
几笔|jibi
机主|jizhu
占时|zhanshi
跳转|tiaozhuan
不认|buren
昨弄|zuonong
我飞|wofei
多有|duoyou
用戶|yonghu
一部|yibu
两点|liangdian
两分钟|liangfenzhong
启用|qiyong
提把|tiba
等额|denge
银行帐户|yinhangzhanghu
稍后|shaohou
驻|zhu
已关|yiguan
提额会|tiehui
五万块|wuwankuai
七点钟|qidianzhong
代了|daile
推后|tuihou
正式|zhengshi
款己|kuanji
烦恼|fannao
并开|bingkai
改回来|gaihuilai
用作|yongzuo
带上|daishang
艹|cao
无所谓|wusuowei
※|※
甪|lu
商业贷款|shangyedaikuan
租衣|zuyi
显示卡|xianshika
错用|cuoyong
有用|youyong
可交|kejiao
很坑|henkeng
餐点|candian
能邦定|nengbangding
与否|yufou
低保|dibao
催促|cuicu
政策|zhengce
口用|kouyong
煤气费|meiqifei
资产|zichan
就够|jiugou
换能|huanneng
办成|bancheng
缓冲|huanchong
永远|yongyuan
我无语|wowuyu
贝付|beifu
银泰|yintai
能服|nengfu
生活费用|shenghuofeiyong
免签|mianqian
跳出|tiaochu
武汉市|wuhanshi
才计|caiji
便换|bianhuan
没放钱|meifangqian
状态|zhuangtai
死亡|siwang
单能|danneng
两块钱|liangkuaiqian
太慢|taiman
借次|jieci
日交|rijiao
几块|jikuai
购机|gouji
打死|dasi
改完|gaiwan
有扣|youkou
确扣|quekou
宽松|kuansong
本书|benshu
先到|xiandao
付收|fushou
打到|dadao
迪拜|dibai
搞不到|gaobudao
鍀|de
学|xue
我爱你|woaini
申诉|shensu
喜欢|xihuan
那卡|naka
刚开|gangkai
看未|kanwei
半个|bange
我想分|woxiangfen
买好|maihao
网代|wangdai
这少|zheshao
还歆|haixin
图解|tujie
水杯|shuibei
看不出|kanbuchu
四百多分|sibaiduofen
息后|xihou
面部|mianbu
界面显示|jiemianxianshi
账户就|zhanghujiu
不鸟|buniao
还往|haiwang
收大|shouda
还会发|haihuifa
等等|dengdeng
酱|jiang
还拉能|hailaneng
我近|wojin
赠|zeng
每笔|meibi
后款|houkuan
可兑换|keduihuan
余利宝|yulibao
烦|fan
用分|yongfen
频度|pindu
账后|zhanghou
工行|gonghang
违期|weiqi
款期|kuanqi
逛|guang
面额|miane
先走|xianzou
怎山|zenshan
购物满|gouwuman
期分|qifen
山畔|shanpan
系统升级|xitongshengji
推荐|tuijian
失败|shibai
优惠政策|youhuizhengce
全照|quanzhao
家店|jiadian
预|yu
毁容|huirong
期待|qidai
神马|shenma
一换|yihuan
赠加|zengjia
设计|sheji
贺|he
成交|chengjiao
淸|qing
一清|yiqing
应付|yingfu
步骤|buzhou
有瑜期|youyuqi
用不交|yongbujiao
副|fu
好处|haochu
最晚|zuiwan
钱分|qianfen
月工资|yuegongzi
郁闷|yumen
还些|haixie
刷|shua
限度|xiandu
微粒|weili
股票投资|gupiaotouzi
凑单|coudan
没多大用|meiduodayong
哪进|najin
本得|bende
代金券|daijinquan
信誉度|xinyudu
能住|nengzhu
总用|zongyong
能选|nengxuan
移期|yiqi
澳门|aomen
反到|fandao
贵重|guizhong
并且|bingqie
完为|wanwei
拾|shi
审批|shenpi
再存|zaicun
重庆|chongqing
想解|xiangjie
寄过来|jiguolai
改后|gaihou
不及|buji
脸付|lianfu
借不出|jiebuchu
调度|diaodu
盖章|gaizhang
道具|daoju
可退回|ketuihui
最有|zuiyou
哪关|naguan
没升|meisheng
大牌|dapai
时会|shihui
黑单|heidan
断开|duankai
修好|xiuhao
右下角|youxiajiao
上账|shangzhang
端能|duanneng
转不动|zhuanbudong
运单|yundan
上代|shangdai
的确|dique
足迹|zuji
预先|yuxian
可美团|kemeituan
推荐人|tuijianren
买书|maishu
后盖会|hougaihui
得到|dedao
不足|buzu
慢点|mandian
购买|goumai
这辈|zhebei
退税|tuishui
一百五十|yibaiwushi
完该|wangai
早来|zaolai
五分钟|wufenzhong
最迟在|zuichizai
出单|chudan
正分|zhengfen
搞错|gaocuo
好久没|haojiumei
以示|yishi
美团外|meituanwai
点卷|dianjuan
小摊|xiaotan
通一|tongyi
不差|bucha
一遍|yibian
携程网|xiechengwang
会出|huichu
存进|cunjin
交花|jiaohua
销费|xiaofei
仔细|zixi
耽误|danwu
一款|yikuan
ali|ali
粮票|liangpiao
才|cai
调额点|diaoedian
宽|kuan
挺好用|tinghaoyong
频率|pinlv
图案|tuan
当微信|dangweixin
没加|meijia
改新|gaixin
麻蚁|mayi
咯|ge
金额满|jineman
老师|laoshi
拼单|pindan
放个|fangge
借天|jietian
网尚|wangshang
秘籍|miji
丟失|diushi
日扣|rikou
市|shi
反|fan
套餐|taocan
加下|jiaxia
业|ye
夜间|yejian
这款|zhekuan
断网|duanwang
平板|pingban
减半|jianban
调不回|diaobuhui
负数|fushu
笔记本|bijiben
估计|guji
算账|suanzhang
解绑|jiebang
经济型|jingjixing
元未够|yuanweigou
一秒钟|yimiaozhong
将款|jiangkuan
跪求|guiqiu
劵|juan
公司|gongsi
出门|chumen
改少|gaishao
外用|waiyong
文化|wenhua
元十|yuanshi
心形|xinxing
对比|duibi
截止|jiezhi
关键|guanjian
还错|haicuo
一通|yitong
试试|shishi
首饰|shoushi
每天|meitian
店里|dianli
下个|xiage
能降|nengjiang
美容|meirong
我冲|wochong
带有|daiyou
取线|quxian
系统维护|xitongweihu
下方|xiafang
转给|zhuangei
能订|nengding
刚点|gangdian
元代|yuandai
等待|dengdai
但|dan
听说|tingshuo
怕|pa
没能|meineng
想先|xiangxian
授权|shouquan
变回|bianhui
校园|xiaoyuan
贷有|daiyou
天算起|tiansuanqi
最多|zuiduo
不玩要|buwanyao
度|du
多日|duori
足额|zue
账户|zhanghu
没次|meici
半小时|banxiaoshi
一足|yizu
单价|danjia
下会|xiahui
唯码|weima
话|hua
制作|zhizuo
交不交|jiaobujiao
潜|qian
一时间|yishijian
选出|xuanchu
免费送|mianfeisong
分没涨|fenmeizhang
不了|buliao
三代|sandai
判定|panding
占|zhan
零提|lingti
负额会|fuehui
借久|jiejiu
复数|fushu
算不算|suanbusuan
咋|za
红酒|hongjiu
期付|qifu
还应|haiying
新开通|xinkaitong
18|18
昨夜|zuoye
大奖|dajiang
改微信|gaiweixin
预期|yuqi
小姐|xiaojie
最新版|zuixinban
交電費|jiaodianfei
改绑|gaibang
信用贷款|xinyongdaikuan
清问|qingwen
我发|wofa
指|zhi
以到|yidao
返到|fandao
房子|fangzi
战时|zhanshi
未邦|weibang
生长|shengzhang
技巧|jiqiao
扫小|saoxiao
心用|xinyong
分在|fenzai
用优|yongyou
啵|bo
奶茶|naicha
浪子|langzi
费|fei
统计|tongji
已借|yijie
变多|bianduo
多换|duohuan
显示文件|xianshiwenjian
撒换|sahuan
二十七|ershiqi
changshi|changshi
户主|huzhu
每次|meici
手機|shouji
挖出|wachu
还会出|haihuichu
刚试|gangshi
屏蔽|pingbi
中指|zhongzhi
学厉|xueli
合二为一|heerweiyi
司法|sifa
服装|fuzhuang
出授|chushou
出货|chuhuo
改名字|gaimingzi
第几次|dijici
in|in
扫能|saoneng
寄钱|jiqian
开始|kaishi
哪能|naneng
一片空白|yipiankongbai
急需|jixu
返帐|fanzhang
大部分|dabufen
隆|long
转微信|zhuanweixin
就付|jiufu
点不进|dianbujin
当兵|dangbing
缩期|suoqi
区别|qubie
多万|duowan
月|yue
公安局|gonganju
来付|laifu
徐州|xuzhou
内容|neirong
付定金|fudingjin
核算|hesuan
那么|name
去向|quxiang
数据|shuju
十点|shidian
校正|jiaozheng
担是|danshi
改错|gaicuo
关清|guanqing
九块|jiukuai
有错|youcuo
一前|yiqian
开票|kaipiao
付款日|fukuanri
垫付|dianfu
奥|ao
垫|dian
申请|shenqing
六个月|liugeyue
佰|bai
国外|guowai
危害|weihai
分数|fenshu
首页|shouye
税点|shuidian
放|fang
险额|xiane
再生|zaisheng
清新|qingxin
退赔|tuipei
黄金会员|huangjinhuiyuan
被控|beikong
151|151
脸部|lianbu
分能|fenneng
一比单|yibidan
稳稳当当|wenwendangdang
不来|bulai
很多|henduo
以用|yiyong
肯德基|kendeji
人际关系|renjiguanxi
凑|cou
性|xing
本该|bengai
人气|renqi
两千块|liangqiankuai
花白|huabai
☆|☆
踩|cai
想|xiang
以为|yiwei
没人|meiren
狗后|gouhou
会发|huifa
收码|shouma
本期|benqi
打进|dajin
下放|xiafang
qqcom|qqcom
免首息|mianshouxi
第二期|dierqi
哪点|nadian
旅行|lvxing
秘鲁|bilu
本省|bensheng
不行|buxing
变负|bianfu
換|huan
中扣|zhongkou
颃|hang
人脉助|renmaizhu
方向|fangxiang
27|27
aini|aini
越南|yuenan
一发|yifa
要利|yaoli
弹出|danchu
我弟|wodi
运|yun
自行|zixing
儿子|erzi
摩拜|mobai
候|hou
工作室|gongzuoshi
关联|guanlian
懂|dong
冰冰|bingbing
招联好|zhaolianhao
收走|shouzou
正在|zhengzai
坐|zuo
察看|chakan
各项|gexiang
笔用|biyong
调节|tiaojie
回不来|huibulai
特定|teding
忽略|hulve
券满|quanman
可多开|keduokai
废卡|feika
用刷|yongshua
那一|nayi
元领|yuanling
喀度|kadu
淘寶退貨|taobaotuihuo
确有|queyou
其中|qizhong
算令|suanling
欲期|yuqi
寻|xun
指教|zhijiao
保险金|baoxianjin
日写|rixie
支援|zhiyuan
没成|meicheng
多用|duoyong
恢复过来|huifuguolai
电信|dianxin
捞|lao
删去|shanqu
不刷|bushua
链接|lianjie
加款|jiakuan
一二百|yierbai
款全|kuanquan
抵付|difu
引用|yinyong
邮箱|youxiang
突然|turan
看货|kanhuo
没钱进|meiqianjin
催收|cuishou
热现|rexian
车能|cheneng
牵扯|qianche
我返|wofan
而定|erding
数多|shuduo
那|na
都还没|douhaimei
嫩|nen
输完|shuwan
晕死|yunsi
存储卡|cunchuka
堤额|die
转至|zhuanzhi
商场|shangchang
关关|guanguan
可收|keshou
晚日|wanri
没关系|meiguanxi
害处|haichu
钱转|qianzhuan
会事|huishi
日中|rizhong
app|app
借收|jieshou
地址|dizhi
调休|diaoxiu
zara|zara
连本|lianben
不顾|bugu
加收|jiashou
不借|bujie
骑车|qiche
周岁|zhousui
通会收|tonghuishou
对于|duiyu
日有|riyou
积|ji
某些|mouxie
领领|lingling
去掉|qudiao
发到|fadao
用款|yongkuan
最久分|zuijiufen
万到|wandao
我住|wozhu
重复使用|chongfushiyong
下载|xiazai
少花|shaohua
取得|qude
名称|mingcheng
事是|shishi
欠位|qianwei
已先|yixian
后次|houci
打来|dalai
能够|nenggou
自行车|zixingche
手收|shoushou
快餐店|kuaicandian
高等|gaodeng
帮|bang
个人|geren
74|74
账卡|zhangka
天数|tianshu
恢复|huifu
复核|fuhe
一加|yijia
并用|bingyong
付嘛|fuma
互斥|huchi
亏|kui
期为|qiwei
请以|qingyi
款扣|kuankou
困难|kunnan
上长|shangzhang
再付|zaifu
没急|meiji
等到|dengdao
郁闷死|yumensi
人脸识别|renlianshibie
扣空|koukong
150|150
提下|tixia
不受|bushou
人|ren
一颗|yike
我取|woqu
贷是|daishi
开能|kaineng
不改|bugai
三百|sanbai
找回|zhaohui
原始|yuanshi
商客|shangke
回乡|huixiang
无话|wuhua
吊灯|diaodeng
每个|meige
换行|huanxing
qing|qing
谢谢|xiexie
跟姐|genjie
字|zi
城|cheng
物质|wuzhi
用做|yongzuo
开张|kaizhang
缘故|yuangu
晚点|wandian
净水器|jingshuiqi
開通|kaitong
代开|daikai
卡全包|kaquanbao
帐会|zhanghui
连帽|lianmao
五一|wuyi
生鲜|shengxian
齐全|qiquan
上去|shangqu
能店|nengdian
欠付|qianfu
十几分钟|shijifenzhong
大爷|daye
有花|youhua
先前|xianqian
试有|shiyou
关心|guanxin
超收|chaoshou
改好|gaihao
收码款|shoumakuan
邮|you
查出来|chachulai
交|jiao
好好|haohao
刷不起|shuabuqi
农村信用|nongcunxinyong
推辞|tuici
签购|qiangou
付账|fuzhang
万分之一|wanfenzhiyi
有礼|youli
刮乐赠|gualezeng
够本|gouben
hui|hui
健康果|jiankangguo
天花|tianhua
乱叫|luanjiao
会升|huisheng
闹|nao
饭馆|fanguan
折上|zheshang
开同|kaitong
上花|shanghua
增|zeng
要开|yaokai
借贷|jiedai
第三次|disanci
多单|duodan
多一分|duoyifen
折能|zheneng
踢|ti
用不着|yongbuzhe
会长|huichang
两日|liangri
讲讲|jiangjiang
混在|hunzai
店能|dianneng
麼|me
重病|zhongbing
十号|shihao
变负会|bianfuhui
能安日|nenganri
手势|shoushi
户名|huming
下用付|xiayongfu
环节|huanjie
海淘|haitao
有立|youli
打错|dacuo
蕾丝|leisi
无借|wujie
从卡|congka
值得|zhide
先生|xiansheng
聚美用|jumeiyong
开么|kaime
能接|nengjie
工作日|gongzuori
券儿|quaner
雷霆|leiting
一会|yihui
书客|shuke
其他人|qitaren
不批|bupi
资讯|zixun
三相|sanxiang
评分标准|pingfenbiaozhun
零点|lingdian
吹|chui
贷款额|daikuane
查去|chaqu
恢复正常|huifuzhengchang
百分之五|baifenzhiwu
太少|taishao
场景|changjing
再分|zaifen
废|fei
丽都|lidu
杂样|zayang
看钱|kanqian
年底|niandi
次月免|ciyuemian
六毛|liumao
一吓|yixia
借坝|jieba
有什去|youshenqu
一个多|yigeduo
到际|daoji
批发网|pifawang
评语|pingyu
调么|diaome
发期|faqi
质料|zhiliao
沒出|meichu
改成|gaicheng
帐期|zhangqi
付出|fuchu
部门|bumen
代理商|dailishang
扣应|kouying
校检码|xiaojianma
人民|renmin
开通|kaitong
不分|bufen
心中|xinzhong
通宝|tongbao
转会|zhuanhui
别锁|biesuo
qq|qq
利益|liyi
进来|jinlai
价|jia
面上|mianshang
提现|tixian
经买|jingmai
度超|duchao
房间|fangjian
費了|feile
三后|sanhou
杭州|hangzhou
负责|fuze
尽享|jinxiang
归还|guihuan
骂|ma
改进|gaijin
九十多|jiushiduo
所欠|suoqian
明确|mingque
超值|chaozhi
头像|touxiang
干涉|ganshe
烦死|fansi
有线|youxian
低才|dicai
千多|qianduo
半天|bantian
房租|fangzu
征|zheng
转存|zhuancun
表情|biaoqing
领错|lingcuo
不送|busong
白板|baiban
四万|siwan
续费|xufei
托|tuo
进钱|jinqian
存过|cunguo
多交|duojiao
校证码|xiaozhengma
我想解|woxiangjie
信才|xincai
遇到|yudao
必定|biding
一夜|yiye
晚晚|wanwan
淘票票|taopiaopiao
对照|duizhao
五十万|wushiwan
做用|zuoyong
返还|fanhuan
选中|xuanzhong
百元|baiyuan
后换|houhuan
还好|haihao
钟|zhong
三十一|sanshiyi
付款人|fukuanren
详细信息|xiangxixinxi
通过率|tongguolv
借三|jiesan
越长|yuezhang
买台|maitai
来说|laishuo
ps|ps
能解|nengjie
天猫店|tianmaodian
码有|mayou
太小|taixiao
多少岁|duoshaosui
车子|chezi
一律|yilv
见|jian
后扣|houkou
广西|guangxi
能分|nengfen
支部|zhibu
搞笑|gaoxiao
子有|ziyou
会乱|huiluan
个人头像|gerentouxiang
全场|quanchang
神秘|shenmi
代的款|daidikuan
什样|shenyang
有用吗|youyongma
内开|neikai
网点|wangdian
借下|jiexia
刷付|shuafu
一致|yizhi
可查|kecha
固有|guyou
最早|zuizao
第二次|dierci
涨额|zhange
两个|liangge
使用|shiyong
车把|cheba
负会|fuhui
查看|zhakan
五佰|wubai
尚|shang
不选|buxuan
降权|jiangquan
优秀|youxiu
什叫|shenjiao
负能|funeng
列|lie
已钱|yiqian
里边|libian
券嘛|quanma
一两年|yiliangnian
走向|zouxiang
我信|woxin
拍|pai
网上支付|wangshangzhifu
后续|houxu
欠控|qiankong
几里|jili
交易规则|jiaoyiguize
总加|zongjia
算用|suanyong
哪有|nayou
东西|dongxi
押金|yajin
户口|hukou
动进|dongjin
节款|jiekuan
这笔|zhebi
太多|taiduo
....|....
元券|yuanquan
十二|shier
镜子|jingzi
夜班|yeban
一下全部|yixiaquanbu
鱼缸|yugang
快捷方式|kuaijiefangshi
三个|sange
十三号|shisanhao
沒到|meidao
没扣费|meikoufei
四十|sishi
可提|keti
房款|fangkuan
电子版|dianziban
选分|xuanfen
我妈|woma
退运|tuiyun
同名|tongming
使作|shizuo
称为|chengwei
普惠会|puhuihui
重绑|zhongbang
好几|haoji
影不|yingbu
很早|henzao
锁死|suosi
几间|jijian
领啦|lingla
扫一扫|saoyisao
满满的|manmande
自助|zizhu
入住|ruzhu
什我用|shenwoyong
之旅|zhilv
网店|wangdian
实现|shixian
账时|zhangshi
冻结|dongjie
想迟|xiangchi
分够|fengou
单券|danquan
会加分|huijiafen
签证|qianzheng
少|shao
欺|qi
会超|huichao
十七号|shiqihao
点率|dianlv
按差|ancha
天猫券|tianmaoquan
伸手|shenshou
錢|qian
银卡|yinka
卡行|kaxing
需大|xuda
共欠|gongqian
记不起|jibuqi
要钱|yaoqian
支末|zhimo
红|hong
十一号|shiyihao
要|yao
查花|chahua
不消|buxiao
冻掉|dongdiao
接受|jieshou
还成|haicheng
刚冲|gangchong
刚买|gangmai
送到|songdao
事宜|shiyi
工资卡|gongzika
男|nan
电视|dianshi
万维|wanwei
查已|chayi
在此之前|zaicizhiqian
往来|wanglai
换请|huanqing
变空|biankong
确定|queding
花罗|hualuo
多要|duoyao
分低会|fendihui
我花|wohua
两千多|liangqianduo
避免|bimian
妈咪|mami
有款|youkuan
到款|daokuan
顶峰|dingfeng
帐单|zhangdan
加载|jiazai
上同|shangtong
投|tou
冷冻|lengdong
七天|qitian
号算|haosuan
尽管|jinguan
集分|jifen
三十几个|sanshijige
花降额|huajiange
内不收|neibushou
一千多块|yiqianduokuai
我父|wofu
消费|xiaofei
谁给我|sheigeiwo
失望|shiwang
一阵|yizhen
通|tong
下不来|xiabulai
语音|yuyin
栅|zha
认出来|renchulai
付给|fugei
拱|gong
删出|shanchu
还算到|haisuandao
满减|manjian
分解|fenjie
没算|meisuan
不退|butui
改至|gaizhi
回话|huihua
做成|zuocheng
拍照|paizhao
共存|gongcun
实体|shiti
好坏|haohuai
五点|wudian
骂人|maren
比率|bilv
增添|zengtian
借取|jiequ
有花坝|youhuaba
告之|gaozhi
想用|xiangyong
约堡|yuebao
三福|sanfu
可以|keyi
配合|peihe
征收|zhengshou
字会|zihui
先利后|xianlihou
上调|shangdiao
折|zhe
害死|haisi
拍下来|paixialai
瑜期|yuqi
用密付|yongmifu
填表|tianbiao
愈期|yuqi
解呀|jieya
货没到|huomeidao
现付|xianfu
订餮|dingtie
提额口|tiekou
太低|taidi
港澳台|gangaotai
衰新|shuaixin
知|zhi
违规行为|weiguixingwei
节|jie
zhifu|zhifu
药费|yaofei
贝来|beilai
去处|quchu
说久|shuojiu
理发|lifa
小数点|xiaoshudian
违约|weiyue
ne|ne
宝货|baohuo
药|yao
齐后|qihou
礼拜|libai
专项|zhuanxiang
能取|nengqu
信息安全|xinxianquan
有时候|youshihou
李维斯|liweisi
鸡饲料|jisiliao
印章|yinzhang
放款|fangkuan
xiugai|xiugai
累积|leiji
补填|butian
风|feng
机号码|jihaoma
提个|tige
扣过去|kouguoqu
u|u
中能|zhongneng
难得|nande
补到|budao
分花|fenhua
六位|liuwei
当地|dangdi
下崴|xiawai
身份|shenfen
额头|etou
pss|pss
天用|tianyong
星力|xingli
一万元|yiwanyuan
聊城|liaocheng
器|qi
正反面|zhengfanmian
锁屏|suoping
升钱|shengqian
有的是|youdeshi
才解|caijie
差不多|chabuduo
有线电视|youxiandianshi
算上去|suanshangqu
永和|yonghe
弊|bi
车牌号|chepaihao
自我|ziwo
三笔|sanbi
断货|duanhuo
关爱|guanai
这句|zheju
还款额|haikuane
上教|shangjiao
能甲|nengjia
必须|bixu
你家|nijia
好几遍|haojibian
证信|zhengxin
南瓜|nangua
不然|buran
多线|duoxian
换换|huanhuan
没返|meifan
帮着|bangzhe
也关|yeguan
清溪|qingxi
无关|wuguan
搞不好|gaobuhao
绑订|bangding
分再|fenzai
完能|wanneng
撤底|chedi
解退|jietui
酷奇|kuqi
税率|shuilv
买下|maixia
付会|fuhui
青青|qingqing
越早|yuezao
这么晚|zhemewan
商改|shanggai
哪期|naqi
影象|yingxiang
算多|suanduo
封空|fengkong
没想点|meixiangdian
养树|yangshu
删卡会|shankahui
单是|danshi
快捷|kuaijie
多退|duotui
但订|danding
修|xiu
好码|haoma
天是|tianshi
用累|yonglei
接清|jieqing
西沟|xigou
完美|wanmei
错误|cuowu
四块|sikuai
请别|qingbie
狂欢节|kuanghuanjie
再缴|zaijiao
从不|congbu
有救|youjiu
二月份|eryuefen
码扫|masao
处置|chuzhi
总多|zongduo
含义|hanyi
降額|jiange
划出|huachu
除掉|chudiao
钱扣|qiankou
调小后|diaoxiaohou
煤气|meiqi
直持|zhichi
主人|zhuren
笔里|bili
权是|quanshi
出处|chuchu
一分钟|yifenzhong
开封|kaifeng
咱们|zanmen
买块|maikuai
预约|yuyue
后多会|houduohui
整个|zhengge
干不了|ganbuliao
贷同|daitong
中|zhong
期能|qineng
提行|tixing
过会|guohui
费用|feiyong
八百|babai
转化|zhuanhua
转进|zhuanjin
测评|ceping
新一轮|xinyilun
礼券|liquan
扣后|kouhou
推延|tuiyan
起腿款|qituikuan
享用|xiangyong
国光|guoguang
酬金|choujin
提不高|tibugao
合同期|hetongqi
看起|kanqi
黄|huang
同学|tongxue
但货|danhuo
法院|fayuan
提错|ticuo
光闭|guangbi
农信|nongxin
某|mou
理赔|lipei
开办|kaiban
设备|shebei
没份|meifen
付过|fuguo
国庆|guoqing
三|san
二天|ertian
怎改|zengai
同理|tongli
商货|shanghuo
再涨|zaizhang
以贷还贷|yidaihuandai
版块|bankuai
爆发|baofa
四毛|simao
需|xu
签好|qianhao
欠钱|qianqian
再领|zailing
充爱奇艺|chongaiqiyi
丢失|diushi
货前|huoqian
错点成|cuodiancheng
退回去|tuihuiqu
所|suo
提度|tidu
或天|huotian
转帐|zhuanzhang
圈子|quanzi
我想查|woxiangcha
阅读|yuedu
加钱|jiaqian
按原|anyuan
意向|yixiang
零食|lingshi
我小蓝|woxiaolan
连交|lianjiao
不少|bushao
前提条件|qiantitiaojian
搞不懂|gaobudong
万分|wanfen
派送|paisong
抛弃|paoqi
欠过|qianguo
女朋友|nvpengyou
双方|shuangfang
货不在|huobuzai
再开|zaikai
中止|zhongzhi
十二用|shieryong
可次|keci
拳|quan
间隔|jiange
蝙蝠|bianfu
几乎|jihu
关可|guanke
片|pian
还款法|haikuanfa
注消|zhuxiao
承诺|chengnuo
挂失|guashi
还贷|huandai
用要|yongyao
工作|gongzuo
票扣|piaokou
那页|naye
一千二|yiqianer
缴清|jiaoqing
查欠|chaqian
有过|youguo
量贩式|liangfanshi
累计|leiji
美金|meijin
什降|shenjiang
重要|zhongyao
关系|guanxi
时间性|shijianxing
举行|juxing
总额|zonge
省|sheng
期的息|qidexi
花销|huaxiao
经验|jingyan
便宜|pianyi
十二月份|shieryuefen
明白|mingbai
使用率|shiyonglv
法能|faneng
还们|haimen
奖励金|jianglijin
有余|youyu
会罚|huifa
前面|qianmian
开甬|kaiyong
说用|shuoyong
货运费|huoyunfei
我读|wodu
相斥|xiangchi
全额|quane
订|ding
仅限|jinxian
度里|duli
总扣|zongkou
到时候|daoshihou
查应|chaying
影像|yingxiang
我花坝|wohuaba
后会算|houhuisuan
花到|huadao
恢复原状|huifuyuanzhuang
开时|kaishi
二三百|ersanbai
六千|liuqian
百分之几|baifenzhiji
举例|juli
哪开|nakai
转卡转|zhuankazhuan
扫得|saode
我俩|wolia
还数|haishu
同时|tongshi
禁言|jinyan
消了|xiaole
物流|wuliu
个人消费|gerenxiaofei
刚满|gangman
往上升|wangshangsheng
开能查|kainengcha
人寿保险|renshoubaoxian
干叨|gandao
一名|yiming
违法行为|weifaxingwei
十二点|shierdian
￣|￣
不会错|buhuicuo
期款|qikuan
立刻|like
邮政网|youzhengwang
量|liang
过开|guokai
绿色|lvse
tst|tst
以防|yifang
简介|jianjie
没货|meihuo
升网|shengwang
乡下人|xiangxiaren
分不在|fenbuzai
家里|jiali
完才|wancai
咔|ka
号摩拜|haomobai
正品|zhengpin
不符|bufu
最小|zuixiao
五角钱|wujiaoqian
储蓄|chuxu
冲好|chonghao
慢提|manti
丢掉|diudiao
请常|qingchang
证和友|zhengheyou
无|wu
办证|banzheng
账单|zhangdan
没管|meiguan
元话|yuanhua
还会算|haihuisuan
付数|fushu
变慢|bianman
余后|yuhou
段时间|duanshijian
說|shuo
可不可以|kebukeyi
周卡|zhouka
到帳|daozhang
弄不清|nongbuqing
动结|dongjie
货款|huokuan
出线|chuxian
不付合|bufuhe
供|gong
旅游网|lvyouwang
能张|nengzhang
清单|qingdan
可降|kejiang
他付|tafu
划|hua
零时|lingshi
害得|haide
分是|fenshi
解不开|jiebukai
卖|mai
至少|zhishao
什时升|shenshisheng
猫|mao
欠|qian
实惠|shihui
不怕|bupa
车牌号码|chepaihaoma
确要|queyao
wan|wan
不一祥|buyixiang
还加|haijia
怎樣|zenyang
号会|haohui
费能|feineng
五福|wufu
阿上|ashang
款付|kuanfu
负着|fuzhe
建立|jianli
妃|fei
扣重|kouzhong
调查|diaocha
实人|shiren
周二|zhouer
浦发银行|pufayinhang
搞了半天|gaolebantian
清欠|qingqian
各人|geren
警察|jingcha
单买|danmai
会加美|huijiamei
事实|shishi
旧卡|jiuka
一夜之间|yiyezhijian
融水|rongshui
具有|juyou
怎梓|zenzi
数是|shushi
济州|jizhou
悄悄|qiaoqiao
提速|tisu
香|xiang
登不去|dengbuqu
商贷|shangdai
出境|chujing
更改|genggai
实在|shizai
抄|chao
基金|jijin
解散|jiesan
做个|zuoge
停车费|tingchefei
帮回|banghui
问要|wenyao
乳|ru
逐渐|zhujian
板块|bankuai
超额|chaoe
真有|zhenyou
多些|duoxie
票钱|piaoqian
算几厘|suanjili
开对|kaidui
有什出|youshenchu
天呐|tianna
短息|duanxi
存|cun
代激|daiji
越大|yueda
借贝|jiebei
扭|niu
额数|eshu
处消|chuxiao
学校|xuexiao
任何人|renheren
早早|zaozao
怎借|zenjie
单后|danhou
事儿|shier
吊|diao
评分|pingfen
里够|ligou
加在一起|jiazaiyiqi
十月份|shiyuefen
可贷|kedai
首收|shoushou
这多|zheduo
液|ye
付帐|fuzhang
五百元|wubaiyuan
日会发|rihuifa
几种|jizhong
xit|xit
结么|jieme
带带|daidai
会率|huilv
强开|qiangkai
一开|yikai
极好|jihao
拜拜|baibai
点进|dianjin
奇|qi
结帐|jiezhang
端口|duankou
将来|jianglai
变过|bianguo
排名|paiming
支宝|zhibao
改卷|gaijuan
没到|meidao
差看|chakan
矛盾|maodun
肿|zhong
银|yin
人太多|rentaiduo
乍|zha
借借|jiejie
预付款|yufukuan
解约|jieyue
回馈|huikui
跳不出|tiaobuchu
一个十二|yigeshier
后果|houguo
排队|paidui
上述|shangshu
改将|gaijiang
脚|jiao
改到|gaidao
过万|guowan
很久没|henjiumei
邮政储蓄|youzhengchuxu
可弄成|kenongcheng
乱来|luanlai
资金|zijin
别家|biejia
这比钱|zhebiqian
只够|zhigou
虾米|xiami
发布|fabu
用卡|yongka
方|fang
宝箱|baoxiang
降调|jiangdiao
鬼|gui
后息|houxi
一同|yitong
下一毕|xiayibi
避过|biguo
卡屏|kaping
负款|fukuan
d|d
写个|xiege
什开|shenkai
国际|guoji
老人|laoren
用密|yongmi
咋会|zahui
刷卡器|shuakaqi
经济|jingji
加急|jiaji
两百元|liangbaiyuan
彻消|chexiao
度图|dutu
157|157
发钱|faqian
算有|suanyou
此|ci
提额慢|tieman
吃完饭|chiwanfan
还会少|haihuishao
新人|xinren
续|xu
取代|qudai
会列进|huiliejin
看|kan
好使|haoshi
异常|yichang
没数|meishu
解决方案|jiejuefangan
需下|xuxia
呈现|chengxian
智格|zhige
联|lian
没拿到|meinadao
玩|wan
年前|nianqian
几回|jihui
会交|huijiao
看上|kanshang
各种|gezhong
购物车|gouwuche
人开|renkai
api|api
丶|zhu
贝|bei
但款|dankuan
根儿|gener
分俩|fenlia
具体条件|jutitiaojian
其余|qiyu
出差|chuchai
作预|zuoyu
调大|diaoda
冲突|chongtu
摇奖|yaojiang
欠额|qiane
解嘛|jiema
水电|shuidian
里交|lijiao
小花|xiaohua
街用|jieyong
那和开|nahekai
授權|shouquan
开不着|kaibuzhe
缺买|quemai
订制|dingzhi
这一单|zheyidan
任何|renhe
哪次|naci
错误代码|cuowudaima
48|48
平台|pingtai
年费|nianfei
用不来|yongbulai
最|zui
水电费|shuidianfei
签合同|qianhetong
时说|shishuo
发给|fagei
双鞋|shuangxie
节清|jieqing
分过|fenguo
不是|bushi
无权|wuquan
只加|zhijia
郑州|zhengzhou
钱喃|qiannan
分刚|fengang
哪儿|naer
海报|haibao
夫|fu
拖欠|tuoqian
这月花|zheyuehua
转钱|zhuanqian
覆约|fuyue
一个月|yigeyue
能干|nenggan
不账|buzhang
末到|modao
非复|feifu
帳户|zhanghu
截不聊|jiebuliao
截个|jiege
安见|anjian
刷面|shuamian
能超|nengchao
天呀|tianya
三百多元|sanbaiduoyuan
十个月|shigeyue
可一|keyi
陪|pei
三千五|sanqianwu
第六期|diliuqi
已过期|yiguoqi
复原|fuyuan
网商开|wangshangkai
帮不上|bangbushang
要时|yaoshi
已未出|yiweichu
原路|yuanlu
拒签|juqian
人去|renqu
没经|meijing
无敌|wudi
抽免|choumian
我想关|woxiangguan
申直|shenzhi
没输|meishu
法定|fading
脱期|tuoqi
年货|nianhuo
拼|pin
已到|yidao
本|ben
hys|hys
农村|nongcun
写人|xieren
啷|lang
我货|wohuo
三天|santian
接单|jiedan
商品价格|shangpinjiage
另一方|lingyifang
调低|diaodi
假如|jiaru
键不亮|jianbuliang
确说|queshuo
返|fan
点|dian
日新|rixin
不是故意|bushiguyi
回个|huige
改回去|gaihuiqu
时该|shigai
获|huo
款项|kuanxiang
没欠|meiqian
一期|yiqi
怎木换|zenmuhuan
此次|cici
nian|nian
优酷|youku
发旧|fajiu
刮胡刀|guahudao
两点钟|liangdianzhong
日|ri
八位|bawei
贷比|daibi
乛|ya
清洗|qingxi
不想|buxiang
至今|zhijin
公号|gonghao
选泽|xuanze
前会|qianhui
约定|yueding
保证金|baozhengjin
进行|jinxing
莫法|mofa
完再|wanzai
很难|hennan
笔数|bishu
百货店|baihuodian
麻辣|mala
合同|hetong
审|shen
弹|dan
八心|baxin
眨眼|zhayan
一分|yifen
膜|mo
退多|tuiduo
交不|jiaobu
彻底|chedi
标签|biaoqian
免密付|mianmifu
主用|zhuyong
分辩|fenbian
跟着|genzhe
花吸|huaxi
我加|wojia
生气|shengqi
叫|jiao
转卡到|zhuankadao
长期贷款|changqidaikuan
贷后|daihou
已过|yiguo
收不收|shoubushou
恶心|exin
有钱人|youqianren
降|jiang
个点|gedian
调大嘛|diaodama
部能|buneng
元能|yuanneng
无法访问|wufafangwen
抽中天|chouzhongtian
号生|haosheng
时输|shishu
昨天下午|zuotianxiawu
画面|huamian
没留|meiliu
先替|xianti
用花|yonghua
当时|dangshi
聚美买|jumeimai
戒|jie
部队|budui
q|q
哪扣|nakou
搞懂|gaodong
我邦|wobang
那钱会|naqianhui
攻略|gonglve
分类|fenlei
我设|woshe
选卡|xuanka
询下|xunxia
交不起|jiaobuqi
碼|ma
变到|biandao
兑换|duihuan
无所不能|wusuobuneng
商城|shangcheng
服务费|fuwufei
乐租|lezu
天要|tianyao
专享|zhuanxiang
我新开|woxinkai
方框|fangkuang
最尽|zuijin
为什么|weishenme
物品|wupin
一下子全部|yixiaziquanbu
淘淘|taotao
你|ni
怎去|zenqu
种类|zhonglei
多人多|duorenduo
目前|muqian
识不出|shibuchu
那想|naxiang
尴尬|ganga
卖方|maifang
变回去|bianhuiqu
需收|xushou
填补|tianbu
带扣|daikou
隐蔽|yinbi
因为|yinwei
清楚|qingchu
差钱|chaqian
店上|dianshang
关掉|guandiao
平时|pingshi
有误|youwu
换满|huanman
我邦定|wobangding
两期|liangqi
被告|beigao
用玛蚁|yongmayi
知不知道|zhibuzhidao
所借|suojie
刚退|gangtui
卡包|kabao
很久很久|henjiuhenjiu
个期|geqi
工具|gongju
糊涂|hutu
充费|chongfei
升高|shenggao
维权|weiquan
移|yi
再下|zaixia
强行|qiangxing
工服|gongfu
無法|wufa
急急|jiji
咬|yao
不虚要|buxuyao
临额|line
点卡|dianka
时刷|shishua
♂|♂
抵现|dixian
快题|kuaiti
先结|xianjie
不许|buxu
完要|wanyao
款码|kuanma
山地车|shandiche
一把|yiba
个|ge
存入|cunru
月长|yuezhang
推销|tuixiao
未来|weilai
省钱|shengqian
推给|tuigei
糸|mi
官方|guanfang
中刷|zhongshua
完有|wanyou
叠加|diejia
多年|duonian
八千|baqian
老号|laohao
小蚂哥|xiaomage
分钟|fenzhong
日未|riwei
九十多块|jiushiduokuai
供暖费|gongnuanfei
可分|kefen
元退|yuantui
新开|xinkai
卡是|kashi
還錢|haiqian
说算下|shuosuanxia
給|gei
绝不会|juebuhui
提申|tishen
单时|danshi
弥补|mibu
快速|kuaisu
荣盛|rongsheng
不开|bukai
还债|huanzhai
降低利率|jiangdililv
年龄|nianling
譬如说|pirushuo
冲|chong
会算|huisuan
一天天|yitiantian
多个|duoge
好些|haoxie
手环|shouhuan
美容美发|meirongmeifa
理由|liyou
再点|zaidian
元次|yuanci
琐|suo
军校|junxiao
开以|kaiyi
想到|xiangdao
网贷|wangdai
洪客|hongke
交小|jiaoxiao
账帮|zhangbang
事项|shixiang
等息|dengxi
金钱|jinqian
额要|eyao
清帐|qingzhang
会窃|huiqie
上定|shangding
五六年|wuliunian
产品|chanpin
这退|zhetui
商代|shangdai
开户|kaihu
宫业|gongye
把款|bakuan
能乱|nengluan
长分|zhangfen
变少|bianshao
完会|wanhui
三十|sanshi
操|cao
按|an
后日|houri
验证|yanzheng
能延|nengyan
满足条件|manzutiaojian
货钱|huoqian
平白无故|pingbaiwugu
缺货|quehuo
没改|meigai
那当|nadang
入帐|ruzhang
存上|cunshang
二个|erge
钱货|qianhuo
低有|diyou
订购|dinggou
项|xiang
元宵节|yuanxiaojie
反弹|fandan
想邦定|xiangbangding
公|gong
房租费|fangzufei
求|qiu
刻意|keyi
比较|bijiao
申请表|shenqingbiao
羊城通|yangchengtong
太晚|taiwan
两倍|liangbei
看有|kanyou
天为|tianwei
银行存款|yinhangcunkuan
不可|buke
没额|meie
给子|geizi
深圳|shenzhen
拒付|jufu
摇倒|yaodao
查寻|chaxun
白|bai
能拉|nengla
时买|shimai
出入|churu
上要|shangyao
回家|huijia
变迁|bianqian
会标|huibiao
求开|qiukai
发还|fahuan
长年|changnian
看不见|kanbujian
预算|yusuan
我莫法|womofa
贱|jian
款后|kuanhou
有助|youzhu
元卷|yuanjuan
收款|shoukuan
后台|houtai
延持|yanchi
专提额|zhuantie
汽车|qiche
按时|anshi
日到|ridao
那领|naling
买家|maijia
提货|tihuo
进人|jinren
钱克|qianke
读取|duqu
扫款|saokuan
第八天|dibatian
二万|erwan
半年|bannian
预计|yuji
腨|shuan
用加|yongjia
跳至|tiaozhi
这开|zhekai
借够|jiegou
如合|ruhe
那调|nadiao
说完|shuowan
好几百|haojibai
产险|chanxian
变|bian
付成|fucheng
才刚|caigang
冲错|chongcuo
xxxx|xxxx
混付|hunfu
决冻|juedong
短借|duanjie
键面|jianmian
碑码|beima
清零|qingling
从复|congfu
再寄|zaiji
挖领|waling
还会|haihui
余下|yuxia
排|pai
乱收费|luanshoufei
帐目|zhangmu
不下|buxia
多分|duofen
查阅|chayue
知付|zhifu
她们|tamen
弄关|nongguan
联系|lianxi
指标|zhibiao
但花|danhua
钱太少|qiantaishao
上个月|shanggeyue
货币|huobi
交还|jiaohuan
夜市|yeshi
见福|jianfu
方太|fangtai
桂林|guilin
半想用|banxiangyong
记到|jidao
大慨|dakai
提前|tiqian
江苏省|jiangsusheng
寻仙|xunxian
赠送给|zengsonggei
存折|cunzhe
补救|bujiu
放宽|fangkuan
我开|wokai
不如|buru
显|xian
押后|yahou
借线|jiexian
明细|mingxi
租金|zujin
里款|likuan
可用|keyong
提倡|tichang
收银台|shouyintai
时分|shifen
领呀|lingya
被动|beidong
从摩拜|congmobai
平衡|pingheng
空白页|kongbaiye
天计|tianji
弟|di
卡才|kacai
不朋是|bupengshi
提鹅|tie
那些|neixie
佳缘|jiayuan
同事|tongshi
什|shen
xxxxx|xxxxx
同过|tongguo
給我開|geiwokai
舒服|shufu
订单号|dingdanhao
同等|tongdeng
日利率|rililv
总去|zongqu
下限|xiaxian
要付|yaofu
只免|zhimian
单纯|danchun
还敢|haigan
名细能|mingxineng
领过|lingguo
下一单|xiayidan
票退|piaotui
变会|bianhui
升回去|shenghuiqu
复杂|fuza
家乡|jiaxiang
储物卡|chuwuka
部长|buzhang
十三|shisan
说开|shuokai
用想|yongxiang
优质|youzhi
花费|huafei
可傲|keao
赢免|yingmian
用些|yongxie
比人|biren
打错字|dacuozi
上开|shangkai
我微|wowei
关会|guanhui
笫|zi
一手|yishou
元会|yuanhui
解邦|jiebang
钱能|qianneng
法律|falv
销账|xiaozhang
弍|er
完好|wanhao
预缴|yujiao
副食店|fushidian
还弹|haidan
转到|zhuandao
满额|mane
买同|maitong
大参林|dacanlin
所有人|suoyouren
实体店|shitidian
贷过|daiguo
安排|anpai
专柜|zhuangui
有助于|youzhuyu
再加|zaijia
渤海|bohai
会限|huixian
没回|meihui
我们|women
買家開|maijiakai
最近|zuijin
投保|toubao
投诉|tousu
切换|qiehuan
二百元|erbaiyuan
三年|sannian
bu|bu
分已|fenyi
借不聊|jiebuliao
金额|jine
转错|zhuancuo
百分之十|baifenzhishi
合计|heji
伲|ni
代驾|daijia
随用|suiyong
花去|huaqu
ya|ya
延至|yanzhi
牙|ya
那比|nabi
小红书|xiaohongshu
分低|fendi
充值|chongzhi
背|bei
荆门|jingmen
改改|gaigai
想华|xianghua
通花唄|tonghuabei
账款|zhangkuan
储蓄卡|chuxuka
刮奖|guajiang
送|song
活跃度|huoyuedu
好餐|haocan
超级|chaoji
购不|goubu
收不上|shoubushang
发张|fazhang
开着|kaizhe
music|music
我手|woshou
撑|cheng
怎嘛|zenma
钱必|qianbi
确让|querang
越过|yueguo
com|com
缺|que
延续|yanxu
分三|fensan
地铁|ditie
未成年人|weichengnianren
火车站|huochezhan
剛開|gangkai
前两天|qianliangtian
短袖|duanxiu
数输错|shushucuo
五千|wuqian
实用|shiyong
肉|rou
借后|jiehou
可续|kexu
意见|yijian
勒个|leige
佩服|peifu
借过|jieguo
情形|qingxing
通玩|tongwan
有个|youge
借口|jiekou
借多|jieduo
查|cha
宴请|yanqing
迟些|chixie
数字证书|shuzizhengshu
意识|yishi
前段时间|qianduanshijian
总部|zongbu
转不上|zhuanbushang
幸运|xingyun
列表|liebiao
续借|xujie
退账|tuizhang
身边|shenbian
单品|danpin
封|feng
数有|shuyou
零售|lingshou
哪时|nashi
一千六|yiqianliu
补满|buman
能花|nenghua
网吧|wangba
掉|diao
不加|bujia
赠给|zenggei
华|hua
日租|rizu
有算|yousuan
违规|weigui
起前|qiqian
定制|dingzhi
武汉|wuhan
津贴|jintie
天|tian
换回来|huanhuilai
大不大|dabuda
这什退|zheshentui
展期|zhanqi
最少|zuishao
还行|haixing
有额|youe
换应|huanying
二类|erlei
首单|shoudan
奖金|jiangjin
时用|shiyong
买花|maihua
数天|shutian
没扣|meikou
但是|danshi
代表|daibiao
需向|xuxiang
商都|shangdou
打过|daguo
活动|huodong
一半一半|yibanyiban
还免|haimian
优衣库|youyiku
维修|weixiu
延长|yanchang
我重|wozhong
含息|hanxi
一涨|yizhang
代付|daifu
为什|weishen
甘久|ganjiu
欢快|huankuai
依赖|yilai
怎么办|zenmeban
联通公司|liantonggongsi
婴贝美|yingbeimei
用同|yongtong
澳大利亚|aodaliya
盆子|penzi
我离|woli
克制|kezhi
给付|geifu
怎么着|zenmezhao
那线|naxian
交完|jiaowan
航空公司|hangkonggongsi
和平|heping
墨西哥|moxige
当钱|dangqian
车费|chefei
老话|laohua
收买|shoumai
办车|banche
一增|yizeng
进账|jinzhang
免期|mianqi
途期|tuqi
卡开|kakai
厦门|xiamen
改还期|gaihaiqi
店铺|dianpu
窗口|chuangkou
分降|fenjiang
总和|zonghe
精确|jingque
钱行|qianxing
能支|nengzhi
回升|huisheng
海外|haiwai
武义县|wuyixian
秘码|mima
两台|liangtai
花多上|huaduoshang
脸通|liantong
字充|zichong
不知|buzhi
zhuanj|zhuanj
复利|fuli
高过|gaoguo
码字|mazi
小卖部|xiaomaibu
越低|yuedi
过款|guokuan
卡止|kazhi
被扣|beikou
写|xie
回卡上|huikashang
途径|tujing
医生|yisheng
通上|tongshang
街上|jieshang
捏|nie
责任|zeren
立牌|lipai
优惠权|youhuiquan
现有|xianyou
分才|fencai
用发|yongfa
餐馆|canguan
冲底|chongdi
自营|ziying
十万块|shiwankuai
努力|nuli
绿|lv
能复|nengfu
阿里|ali
余生|yusheng
钱应|qianying
那下|naxia
人生|rensheng
面息|mianxi
南昌|nanchang
生份证|shengfenzheng
先是|xianshi
起初|qichu
大于|dayu
通不|tongbu
各扣|gekou
多账|duozhang
士兵证|shibingzheng
来用|laiyong
相关联|xiangguanlian
简单|jiandan
咔里|kali
期内|qinei
先续|xianxu
学历|xueli
首贷会|shoudaihui
到底|daodi
两万块|liangwankuai
改号|gaihao
天然|tianran
地摊|ditan
该笔|gaibi
不换会|buhuanhui
账换|zhanghuan
此项|cixiang
随到|suidao
分为|fenwei
一万块|yiwankuai
外币|waibi
刚用|gangyong
维品|weipin
借多会|jieduohui
完以|wanyi
哪选|naxuan
可调|kediao
能租|nengzu
依旧|yijiu
理会|lihui
动手|dongshou
充值卡|chongzhika
跳回去|tiaohuiqu
承认|chengren
ap|ap
连锁|liansuo
时钱会|shiqianhui
误|wu
设好|shehao
谱|pu
礼品|lipin
不足以|buzuyi
自动化|zidonghua
调额|diaoe
位|wei
最多能|zuiduoneng
对账|duizhang
可德基|kedeji
不算|busuan
结完|jiewan
ki|ki
能负|nengfu
几率|jilv
节日|jieri
比应|biying
吗|ma
回到|huidao
自|zi
订正|dingzheng
换乱|huanluan
发送至|fasongzhi
可延|keyan
备用|beiyong
乐视|leshi
具备条件|jubeitiaojian
五千元|wuqianyuan
skk|skk
进去|jinqu
短期贷款|duanqidaikuan
能花出|nenghuachu
单他|danta
体检|tijian
受到|shoudao
会转|huizhuan
多支|duozhi
祢好|mihao
香港|xianggang
时不时|shibushi
五毛|wumao
能省|nengsheng
度够|dugou
找寻|zhaoxun
提点|tidian
蛮足|manzu
会算到|huisuandao
取款|qukuan
换上|huanshang
拖个|tuoge
敢|gan
怎开样|zenkaiyang
先关|xianguan
鼓励|guli
久久|jiujiu
波|bo
多高|duogao
叫用|jiaoyong
多号|duohao
改扣|gaikou
八九点|bajiudian
抽起|chouqi
送达|songda
定房|dingfang
后下|houxia
乱搞|luangao
付时|fushi
往后|wanghou
压力|yali
延期|yanqi
不再|buzai
店后|dianhou
拍摄|paishe
没多久|meiduojiu
结合|jiehe
借不上|jiebushang
售|shou
可币|kebi
好烦|haofan
贝壳|beike
规|gui
加|jia
撒|sa
优缺点|youquedian
两百多|liangbaiduo
账钱|zhangqian
如需|ruxu
徣|jie
会付|huifu
单钱|danqian
花是|huashi
胜额|shenge
尚有|shangyou
小鸣|xiaoming
值|zhi
认清|renqing
个例|geli
翻倍|fanbei
宝|bao
念|nian
女儿|nver
还款|haikuan
缴付|jiaofu
虫|chong
级|ji
毕业|biye
件|jian
无语|wuyu
十么|shime
点止|dianzhi
上充|shangchong
apple|apple
正数|zhengshu
日子|rizi
决定|jueding
能不刷|nengbushua
qb|qb
行么|xingme
接口|jiekou
上网|shangwang
啲|di
写错|xiecuo
分控|fenkong
家|jia
二百|erbai
不设|bushe
免息|mianxi
后悔|houhui
方法|fangfa
天刚|tiangang
骗人|pianren
划款|huakuan
用网|yongwang
对用|duiyong
问好|wenhao
沃尔玛|woerma
本是|benshi
pp|pp
灰|hui
别跟我|biegenwo
什还会|shenhaihui
总款|zongkuan
代购|daigou
奖|jiang
核对|hedui
永退|yongtui
点解|dianjie
打开|dakai
零头|lingtou
纠纷|jiufen
度算大|dusuanda
反款|fankuan
做点|zuodian
肆拾|sishi
聚宝|jubao
出票|chupiao
下下|xiaxia
联系方式|lianxifangshi
扣娜|kouna
这发|zhefa
调高来|diaogaolai
享|xiang
验证码|yanzhengma
收货人|shouhuoren
途虎|tuhu
扣出|kouchu
用用|yongyong
换款|huankuan
考驾照|kaojiazhao
花贝|huabei
先看|xiankan
左右|zuoyou
出具|chuju
换|huan
九个|jiuge
重用|zhongyong
帮查|bangcha
二年|ernian
完会开|wanhuikai
相互|xianghu
一两天|yiliangtian
分歧|fenqi
加微信|jiaweixin
驳回|bohui
跟结|genjie
个月免|geyuemian
共需|gongxu
值会|zhihui
若有|ruoyou
九百|jiubai
取消资格|quxiaozige
四百多|sibaiduo
天虹|tianhong
资金紧张|zijinjinzhang
柳州|liuzhou
要查|yaocha
台湾人|taiwanren
从何而来|congheerlai
用额|yonge
售货机|shouhuoji
改月|gaiyue
所购|suogou
扣卡上|koukashang
本来|benlai
两|liang
我收|woshou
搞定|gaoding
订机票|dingjipiao
退过|tuiguo
不|bu
jiu|jiu
吃|chi
二十次|ershici
叫邦定|jiaobangding
日萌|rimeng
百多|baiduo
怎末|zenmo
首要|shouyao
临得|linde
爱|ai
相连|xianglian
双向|shuangxiang
多花|duohua
单位|danwei
足|zu
挖里|wali
不张|buzhang
消耗|xiaohao
闪付|shanfu
付小|fuxiao
钱入|qianru
朋友圈|pengyouquan
ja|ja
暂时|zanshi
分以|fenyi
做堤|zuodi
密码|mima
债|zhai
友付|youfu
还少|haishao
那张|nazhang
码花|mahua
数和算|shuhesuan
当面|dangmian
之家|zhijia
蜜蜜|mimi
三点|sandian
接着|jiezhe
怀有|huaiyou
互换|huhuan
交到|jiaodao
两年|liangnian
电网|dianwang
我交过|wojiaoguo
太坑|taikeng
收货|shouhuo
能改|nenggai
挑|tiao
欠九佰多|qianjiubaiduo
缺陷|quexian
大礼包|dalibao
手套|shoutao
完退|wantui
现|xian
四百五十|sibaiwushi
发个|fage
货是|huoshi
客服|kefu
洛阳|luoyang
礼|li
代收款|daishoukuan
几十分钟|jishifenzhong
找不着|zhaobuzhe
海购|haigou
院校|yuanxiao
他点|tadian
那天|natian
增长|zengzhang
桌面上|zhuomianshang
连充|lianchong
榜定|bangding
退换货|tuihuanhuo
xxx|xxx
卡钱|kaqian
我换款|wohuankuan
小姐姐|xiaojiejie
卖价|maijia
息为|xiwei
未经|weijing
算在里面|suanzailimian
那帮|nabang
来到|laidao
时卡|shika
七千|qiqian
款厂|kuanchang
借给|jiegei
平安|pingan
买灯|maideng
而交|erjiao
寻找|xunzhao
是|shi
原来|yuanlai
华夏银行|huaxiayinhang
54|54
度太低|dutaidi
一人|yiren
不涨|buzhang
找下|zhaoxia
声请|shengqing
莫名其妙|momingqimiao
杯|bei
填低|tiandi
以外|yiwai
宝卡有|baokayou
也就是说|yejiushishuo
卡券|kaquan
出|chu
缺点|quedian
寄送|jisong
巴士|bashi
理财产品|licaichanpin
两仟元|liangqianyuan
位置|weizhi
大意|dayi
四天|sitian
哪哈|naha
全款|quankuan
信物|xinwu
哪取|naqu
所买|suomai
上会|shanghui
监管|jianguan
我连点|woliandian
付面|fumian
还出|haichu
再交|zaijiao
四个|sige
问问|wenwen
规格|guige
两三千元|liangsanqianyuan
没点|meidian
实数|shishu
不长额|buzhange
公开|gongkai
赠值|zengzhi
滴|di
时付|shifu
能关|nengguan
多少|duoshao
模式|moshi
商网|shangwang
或者说|huozheshuo
有刷|youshua
算作|suanzuo
钱台|qiantai
会过|huiguo
栏|lan
杂花|zahua
聊天|liaotian
多才|duocai
道理|daoli
应急|yingji
工商登记|gongshangdengji
我无发|wowufa
尾款|weikuan
附属|fushu
这是|zheshi
说免|shuomian
大底|dadi
点数|dianshu
那如|naru
为何|weihe
充不上|chongbushang
讠|yan
受到限制|shoudaoxianzhi
随关|suiguan
关完|guanwan
企业信用|qiyexinyong
额前|eqian
盗|dao
咋充|zachong
没去|meiqu
太气|taiqi
分错|fencuo
买类|mailei
放期|fangqi
闭|bi
扣行|kouxing
ma|ma
用花坝|yonghuaba
成度|chengdu
退查|tuicha
旧旧|jiujiu
一所|yisuo
大学生|daxuesheng
那项|naxiang
登不上|dengbushang
评价|pingjia
摇|yao
退换|tuihuan
外省|waisheng
哪报|nabao
明显|mingxian
填下|tianxia
浙江省|zhejiangsheng
十几|shiji
付可|fuke
不太会|butaihui
扫额|saoe
没用过|meiyongguo
开|kai
按揭|anjie
找券|zhaoquan
晕|yun
是因为|shiyinwei
倍|bei
t|t
店家|dianjia
费劲|feijin
哪家|najia
会无原|huiwuyuan
那摩拜|namobai
往出|wangchu
约|yue
消掉|xiaodiao
前往|qianwang
成功|chenggong
哪来|nalai
六月份|liuyuefen
退过来|tuiguolai
租用|zuyong
出租车|chuzuche
过账|guozhang
日要|riyao
可乐|kele
调钱|diaoqian
老息|laoxi
查账|chazhang
一瞬间|yishunjian
听不懂|tingbudong
透出|touchu
打印发票|dayinfapiao
机场|jichang
私自|sizi
钱款|qiankuan
金立|jinli
学校名称|xuexiaomingcheng
销除|xiaochu
购付|goufu
各个|gege
数额|shue
调少|diaoshao
六|liu
去年|qunian
内用|neiyong
认定|rending
坚决|jianjue
信收|xinshou
全称|quancheng
唱歌|changge
转让|zhuanrang
长久|changjiu
重置|zhongzhi
转正|zhuanzheng
我且|woqie
右下方|youxiafang
日应|riying
日会变|rihuibian
在内|zainei
间|jian
分兑|fendui
我想点|woxiangdian
退卷|tuijuan
一齐|yiqi
扫不起|saobuqi
如向|ruxiang
再延|zaiyan
补补|bubu
进线|jinxian
有利|youli
拖延|tuoyan
勾|gou
流水账|liushuizhang
选者|xuanzhe
小贷|xiaodai
题额|tie
全用|quanyong
解读|jiedu
快抢|kuaiqiang
哪天|natian
我长|wozhang
此笔|cibi
保费|baofei
wufad|wufad
阿|a
单用|danyong
忙|mang
很小|henxiao
能卖|nengmai
万是|wanshi
吃喝玩乐|chihewanle
号码|haoma
说会|shuohui
删嘛|shanma
用续|yongxu
同步|tongbu
提先|tixian
发出|fachu
大家|dajia
未确定|weiqueding
合格|hege
不多|buduo
调解|tiaojie
上限|shangxian
大哥|dage
而且|erqie
打車|dache
扫微信|saoweixin
但算到|dansuandao
首先|shouxian
电|dian
证过|zhengguo
未出|weichu
扫|sao
定时|dingshi
由|you
贷关|daiguan
申|shen
要邦|yaobang
银子|yinzi
通不过|tongbuguo
提一提|tiyiti
三部|sanbu
深林|shenlin
下不差|xiabucha
即时|jishi
哪些项目|neixiexiangmu
家政公司|jiazhenggongsi
后存|houcun
淘宝|taobao
挣|zheng
回微|huiwei
专线|zhuanxian
网站|wangzhan
此号|cihao
九月份|jiuyuefen
好听|haoting
里少|lishao
教|jiao
wufa|wufa
方设|fangshe
怎么|zenme
办理|banli
用度|yongdu
一百块|yibaikuai
没为|meiwei
有手|youshou
里花|lihua
里拉|lila
网商大贷|wangshangdadai
有车有房|youcheyoufang
限用|xianyong
里己|liji
系统|xitong
酷狗会|kugouhui
八日|bari
限额|xiane
无力|wuli
限定|xianding
罰息|faxi
信换|xinhuan
初一|chuyi
弄不好|nongbuhao
挖宝里|wabaoli
罢休|baxiu
提上去|tishangqu
撤掉|chediao
负八|fuba
充上|chongshang
航班|hangban
放心|fangxin
利息支出|lixizhichu
哪领|naling
一性|yixing
看下|kanxia
德|de
和解|hejie
重借|zhongjie
负费|fufei
借努|jienu
先给|xiangei
keyi|keyi
一点|yidian
支取|zhiqu
完毕|wanbi
央行|yanghang
权限|quanxian
下来|xialai
继承|jicheng
扫用|saoyong
钱换|qianhuan
花有|huayou
支发倍|zhifabei
操心|caoxin
底提|diti
集成|jicheng
华菜士|huacaishi
证号|zhenghao
调错|diaocuo
零有|lingyou
品嘛|pinma
ban|ban
往里|wangli
我强|woqiang
好不好|haobuhao
调制|tiaozhi
临近|linjin
餐饮|canyin
慢到|mandao
大度|dadu
公众|gongzhong
用会|yonghui
什不|shenbu
产业|chanye
租完|zuwan
赶上|ganshang
放入|fangru
运气|yunqi
不像|buxiang
还账|huanzhang
还原|huanyuan
笔画|bihua
并非|bingfei
下架|xiajia
玩意儿|wanyier
不放|bufang
拍个|paige
打电话|dadianhua
免密|mianmi
区域|quyu
到件|daojian
后过|houguo
怎什|zenshen
加快|jiakuai
提么|time
借光|jieguang
变得|biande
旧|jiu
早就|zaojiu
商加|shangjia
繁忙|fanmang
当当|dangdang
成为|chengwei
那件|najian
讨厌|taoyan
钱里|qianli
不知不觉|buzhibujue
zhs|zhs
换托|huantuo
提成|ticheng
转赠|zhuanzeng
整年|zhengnian
坏处|huaichu
查询|chaxun
拿到|nadao
哈喽|halou
分有|fenyou
短点|duandian
期中|qizhong
翻|fan
涵能|hanneng
锁扣|suokou
腿|tui
收礼|shouli
没收|moshou
业面|yemian
优惠价|youhuijia
偷期|touqi
公式|gongshi
天全|tianquan
兜|dou
有条|youtiao
不好意思|buhaoyisi
邮费|youfei
买款|maikuan
还清|huanqing
摇一摇必|yaoyiyaobi
两单|liangdan
扣微信|kouweixin
没码|meima
钢化|ganghua
碰到|pengdao
巳|si
减免|jianmian
叮|ding
点扣|diankou
没结|meijie
卡上|kashang
动充|dongchong
gmarket|gmarket
退去|tuiqu
多刷|duoshua
九龙|jiulong
没充|meichong
哪够|nagou
储值卡|chuzhika
透露|toulu
例子|lizi
以来|yilai
星期六|xingqiliu
服费|fufei
六月天|liuyuetian
应为|yingwei
连接|lianjie
联通|liantong
核|he
洗用|xiyong
人问|renwen
扣够|kougou
来刷|laishua
好开|haokai
从|cong
朋友家|pengyoujia
没摇到|meiyaodao
胀|zhang
查要|chayao
官款|guankuan
螚|nai
大号|dahao
并己|bingji
清收|qingshou
有理|youli
◎|◎
66|66
借个款|jiegekuan
期是|qishi
抱|bao
一台|yitai
基地|jide
可放|kefang
立马|lima
交交|jiaojiao
仍为|rengwei
冲抵|chongdi
元用|yuanyong
不必|bubi
几十元|jishiyuan
笔账|bizhang
对应|duiying
动静|dongjing
刚有|gangyou
强|qiang
立省|lisheng
一场|yichang
晚间|wanjian
聚美上|jumeishang
完卡|wanka
期全|qiquan
二十四|ershisi
出账|chuzhang
刚刚|ganggang
终是|zhongshi
什请|shenqing
图像|tuxiang
神奇|shenqi
魔拜|mobai
没花|meihua
单次|danci
计费|jifei
遗期|yiqi
两千多元|liangqianduoyuan
奶|nai
我算|wosuan
宾馆|binguan
没消|meixiao
减价|jianjia
能立|nengli
从事|congshi
叧|gua
没少|meishao
卡通|katong
太高|taigao
人脉|renmai
开心|kaixin
加密|jiami
心想|xinxiang
高利贷|gaolidai
不好|buhao
这钱|zheqian
一栏|yilan
未退|weitui
怀款|huaikuan
没会|meihui
从叠|congdie
外|wai
两者|liangzhe
结付|jiefu
日向|rixiang
负影|fuying
最多收|zuiduoshou
没成工|meichenggong
乱扣|luankou
另期|lingqi
饿度|edu
那份会|nafenhui
半月|banyue
西吉县|xijixian
学都|xuedou
能往|nengwang
咩|mie
快快|kuaikuai
升|sheng
植物|zhiwu
我留|woliu
一息券|yixiquan
号花|haohua
法律法规|falvfagui
一扫用|yisaoyong
药店|yaodian
鞋子|xiezi
分频|fenpin
商超|shangchao
总么用|zongmeyong
平分|pingfen
一两百|yiliangbai
台|tai
一看|yikan
发上去|fashangqu
论证|lunzheng
我后|wohou
囙|yin
超长|chaozhang
骑摩拜|qimobai
效验|xiaoyan
早餐|zaocan
零钱|lingqian
名牌|mingpai
这比|zhebi
同微信|tongweixin
钱妈|qianma
临|lin
我会|wohui
可服|kefu
机刷|jishua
脸是|lianshi
如今|rujin
发款|fakuan
未激活|weijihuo
险|xian
信用|xinyong
美瞳|meitong
两三点|liangsandian
会复|huifu
額算|esuan
日率|rilv
绐|dai
包是|baoshi
不查|bucha
一点点|yidiandian
宝给|baogei
新款|xinkuan
计录|jilu
共能|gongneng
买滴|maidi
旁边|pangbian
多转|duozhuan
美团定|meituanding
一百只|yibaizhi
一百|yibai
抵去|diqu
整体|zhengti
一降|yijiang
确|que
会负|huifu
不动|budong
玩要|wanyao
快款|kuaikuan
手机卡|shoujika
出租屋|chuzuwu
得付|defu
双份|shuangfen
ruh|ruh
需请|xuqing
网页|wangye
能条|nengtiao
换收|huanshou
真慢|zhenman
分不鸟|fenbuniao
鱼花|yuhua
改么|gaime
我想长|woxiangzhang
能额|nenge
退回|tuihui
有次|youci
另设|lingshe
到子|daozi
戒备|jiebei
五个|wuge
他会|tahui
几条|jitiao
指令|zhiling
一占|yizhan
管逼|guanbi
厉害|lihai
停机|tingji
不准|buzhun
便用|bianyong
升至|shengzhi
北山|beishan
块钱|kuaiqian
签兑|qiandui
借行|jiexing
打底|dadi
开免|kaimian
滴钱会|diqianhui
现定|xianding
哪栏|nalan
那就算了|najiusuanle
河南|henan
完成|wancheng
不交咯|bujiaoge
未用|weiyong
类型|leixing
难度|nandu
美|mei
最底|zuidi
付付|fufu
看着|kanzhe
花店|huadian
比上|bishang
优点|youdian
快些|kuaixie
花钱|huaqian
表示|biaoshi
借会|jiehui
安卓|anzhuo
狂|kuang
乱账|luanzhang
菜单|caidan
便于|bianyu
分底|fendi
被执行人|beizhixingren
应下|yingxia
过日子|guorizi
借租|jiezu
凌晨|lingchen
会弹|huidan
完清|wanqing
期满|qiman
很慢|henman
号服|haofu
义马|yima
查用|chayong
付滴|fudi
改掉|gaidiao
每有|meiyou
更少|gengshao
刚看|gangkan
hello|hello
最佳|zuijia
益处|yichu
同|tong
莪|e
定于|dingyu
我共欠|wogongqian
天手|tianshou
要用|yaoyong
函在|hanzai
买回来|maihuilai
记息|jixi
商有|shangyou
开启|kaiqi
恶意|eyi
信|xin
一满|yiman
总帐|zongzhang
一拍|yipai
耍|shua
幵|jian
我摩拜|womobai
干通|gantong
邀进|yaojin
黄人|huangren
续住|xuzhu
罗|luo
帮别人|bangbieren
饯|jian
能为|nengwei
什莫|shenmo
公交|gongjiao
谈|tan
这该|zhegai
常|chang
收多|shouduo
快要|kuaiyao
制度|zhidu
流动资金|liudongzijin
售后|shouhou
居民|jumin
关没|guanmei
明细帐|mingxizhang
人群|renqun
识|shi
按笔|anbi
存不进|cunbujin
几项|jixiang
我认|woren
属实|shushi
异议|yiyi
名|ming
姓用|xingyong
就用到|jiuyongdao
以前|yiqian
归整|guizheng
身份验证|shenfenyanzheng
这么久|zhemejiu
网游|wangyou
咋办|zhaban
买来|mailai
分挺|fenting
缓期|huanqi
本身|benshen
见长|jianzhang
台灣|taiwan
哪花|nahua
奶奶|nainai
租平|zuping
消除|xiaochu
电器|dianqi
住册|zhuce
降回|jianghui
宝卡用|baokayong
毕业证|biyezheng
我张|wozhang
能补|nengbu
字样|ziyang
四千多|siqianduo
那边|nabian
减钱|jianqian
证能|zhengneng
wai|wai
含|han
骚扰|saorao
成团|chengtuan
躲|duo
度变|dubian
已改|yigai
缓|huan
复活|fuhuo
勿|wu
为手|weishou
第几天|dijitian
才能|caineng
转够|zhuangou
看能|kanneng
時|shi
太短|taiduan
我想询|woxiangxun
掉换|diaohuan
没退|meitui
有负|youfu
中国农业银行|zhongguonongyeyinhang
什用|shenyong
钱用|qianyong
想分|xiangfen
―|―
二十|ershi
发生变化|fashengbianhua
时限|shixian
用边|yongbian
一千元|yiqianyuan
找|zhao
怪|guai
千没|qianmei
日计|riji
次后|cihou
估定|guding
如图所示|rutusuoshi
还查|haicha
得出|dechu
做能|zuoneng
咖|ka
几好|jihao
帮提|bangti
误差|wucha
问样|wenyang
预知|yuzhi
交多|jiaoduo
以|yi
货点|huodian
币能|bineng
涨|zhang
借息|jiexi
连分|lianfen
莲花|lianhua
富迪|fudi
八月|bayue
不手|bushou
期望|qiwang
上为|shangwei
再美团|zaimeituan
借人|jieren
会以|huiyi
我别|wobie
账目|zhangmu
施华洛|shihualuo
非故意|feiguyi
chixu|chixu
卡借|kajie
后本|houben
利息|lixi
清算|qingsuan
他款|takuan
化不开|huabukai
中信银行|zhongxinyinhang
印象|yinxiang
能积|nengji
喜士|xishi
总期|zongqi
我扣|wokou
吐乱|tuluan
换成|huancheng
充活费|chonghuofei
因未|yinwei
没借|meijie
回复|huifu
顶|ding
点评|dianping
会清|huiqing
三佰元|sanbaiyuan
七百多|qibaiduo
借款人|jiekuanren
无息|wuxi
限款|xiankuan
良|liang
待出|daichu
我花贝|wohuabei
服完|fuwan
弹跳|dantiao
我卡|woka
共同|gongtong
若到|ruodao
有付|youfu
五十元|wushiyuan
然扫|ransao
崔|cui
永久性|yongjiuxing
号子|haozi
钱存|qiancun
广州|guangzhou
转不生|zhuanbusheng
减除|jianchu
日行|rixing
不换|buhuan
斯|si
过炸货|guozhahuo
辨别|bianbie
太人|tairen
融合|ronghe
删除|shanchu
次笔|cibi
购物点|gouwudian
上门|shangmen
退还|tuihuan
车牌|chepai
一千块|yiqiankuai
末用|moyong
管理费|guanlifei
那扣|nakou
可升|kesheng
中请|zhongqing
算进去|suanjinqu
珐|fa
提请|tiqing
选成|xuancheng
刚送|gangsong
自持|zichi
第三个|disange
还期|haiqi
蛮|man
帐户名|zhanghuming
时要|shiyao
摊位|tanwei
即可|jike
建设|jianshe
明信|mingxin
还卡|haika
别一|bieyi
一起|yiqi
调底|diaodi
官网|guanwang
初始值|chushizhi
顺丰车|shunfengche
fen|fen
适应|shiying
以此类推|yicileitui
魅族|meizu
喝|he
场合|changhe
心里|xinli
撤出|chechu
打不开|dabukai
懒得|lande
提的度|tidedu
刚好|ganghao
若何|ruohe
未通|weitong
租车|zuche
dut|dut
天天|tiantian
我确|woque
宜家|yijia
企业|qiye
暂用|zanyong
离开|likai
属|shu
跑|pao
里头|litou
不止|buzhi
地铁票|ditiepiao
合作|hezuo
点整|dianzheng
帐内|zhangnei
一摇取|yiyaoqu
军人|junren
交易平台|jiaoyipingtai
還是|haishi
完收|wanshou
一整天|yizhengtian
券后|quanhou
少付|shaofu
美团点|meituandian
还收|haishou
自由|ziyou
详单|xiangdan
大批量|dapiliang
适宜|shiyi
列入|lieru
忘后|wanghou
部款|bukuan
得票|depiao
百天|baitian
三十块|sanshikuai
一出|yichu
花过|huaguo
解不|jiebu
明细账|mingxizhang
贷款|daikuan
激|ji
往外|wangwai
凡人|fanren
关拉|guanla
迟|chi
我出|wochu
后该|hougai
转移|zhuanyi
屎|shi
最迟|zuichi
会先|huixian
睌|man
蓝车|lanche
看书|kanshu
卡券包|kaquanbao
跨年度|kuaniandu
变来变去|bianlaibianqu
很无语|henwuyu
为森|weisen
坝|ba
各|ge
孩子|haizi
意外|yiwai
跳过|tiaoguo
用法|yongfa
时退|shitui
八月份|bayuefen
开拓|kaituo
聚力|juli
帳单|zhangdan
上学|shangxue
低到|didao
发送信息|fasongxinxi
小时|xiaoshi
那会|nahui
拍错|paicuo
怎么回事|zenmehuishi
万多元|wanduoyuan
快充|kuaichong
账下|zhangxia
能算|nengsuan
信愈|xinyu
功|gong
几家|jijia
删掉|shandiao
误点|wudian
减息|jianxi
般款行|bankuanxing
没升过|meishengguo
我美团|womeituan
货到|huodao
前台|qiantai
九千多|jiuqianduo
路边|lubian
查花坝|chahuaba
调动|diaodong
原地|yuandi
人进|renjin
灶|zao
出现异常|chuxianyichang
付少|fushao
何原因|heyuanyin
早上|zaoshang
曾经|cengjing
措施|cuoshi
扫出来|saochulai
三千|sanqian
回对|huidui
解答|jieda
还闭|haibi
只少|zhishao
白嫩|bainen
近|jin
上查|shangcha
进场|jinchang
没有|meiyou
软|ruan
借支|jiezhi
网商贷|wangshangdai
哒|da
新年|xinnian
不聊|buliao
展示柜|zhanshigui
总过|zongguo
能充|nengchong
免税|mianshui
只服|zhifu
上点|shangdian
超出预算|chaochuyusuan
我记|woji
査|zha
办卡|banka
再花|zaihua
根本|genben
混乱|hunluan
它关|taguan
借错|jiecuo
参与|canyu
挺少|tingshao
期先|qixian
银行|yinhang
聊天记录|liaotianjilu
转在|zhuanzai
降定|jiangding
咋领|zaling
结出|jiechu
大过年|daguonian
月租费|yuezufei
不怎么|buzenme
调换|diaohuan
营销|yingxiao
几十次|jishici
连卡|lianka
食品|shipin
连续|lianxu
脱|tuo
分升|fensheng
提额额|tiee
日志|rizhi
因过|yinguo
免洗|mianxi
原价|yuanjia
能领|nengling
越来越低|yuelaiyuedi
兩个|liangge
公平|gongping
违法|weifa
呵己|heji
为社|weishe
不去|buqu
店费|dianfei
年份|nianfen
短期|duanqi
强烈要求|qianglieyaoqiu
撤除|chechu
任然|renran
期要|qiyao
代款|daikuan
运输|yunshu
混合|hunhe
再关|zaiguan
返回|fanhui
中点|zhongdian
第三笔|disanbi
何处|hechu
还乱|hailuan
积累|jilei
减小|jianxiao
网络游戏|wangluoyouxi
抵用|diyong
未改|weigai
退还给|tuihuangei
买车|maiche
下会收|xiahuishou
泸州|luzhou
重试|zhongshi
替|ti
高有|gaoyou
基准|jizhun
分到|fendao
shids|shids
办不到|banbudao
每期|meiqi
升上去|shengshangqu
应响|yingxiang
第四期|disiqi
段位|duanwei
九十元|jiushiyuan
准|zhun
同意|tongyi
用话|yonghua
xinyong|xinyong
設|she
来个|laige
刚花|ganghua
以过|yiguo
有收|youshou
南充|nanchong
今天上午|jintianshangwu
下用|xiayong
否|fou
另一边|lingyibian
钱不动|qianbudong
坑|keng
干嘛|ganma
鞋|xie
县体|xianti
旺旺|wangwang
投是|toushi
次期|ciqi
商标|shangbiao
黄花|huanghua
订单|dingdan
图标|tubiao
退|tui
我下|woxia
收錢码|shouqianma
大宗|dazong
不小|buxiao
久|jiu
再次|zaici
回归|huigui
仅|jin
上诉|shangsu
下挂|xiagua
退是|tuishi
何必|hebi
收收|shoushou
开起|kaiqi
八号|bahao
驗證|yanzheng
所送|suosong
一千五|yiqianwu
昵|ni
订房间|dingfangjian
没买成|meimaicheng
多得|duode
反馈|fankui
回调|huidiao
扣会收|kouhuishou
成扫|chengsao
弹出来|danchulai
结呗|jiebei
选择|xuanze
哪张|nazhang
缓存|huancun
何谈|hetan
个个|gege
老不对|laobudui
你们|nimen
少有|shaoyou
现了|xianle
13|13
解冻|jiedong
试用|shiyong
我算下|wosuanxia
脸行|lianxing
云|yun
折现|zhexian
额多|eduo
不减|bujian
学生|xuesheng
短|duan
三遍|sanbian
退至|tuizhi
餐饮店|canyindian
续约|xuyue
码能|maneng
过程|guocheng
改换|gaihuan
缓迟|huanchi
水费|shuifei
微信换|weixinhuan
笔|bi
信用等级|xinyongdengji
点动|diandong
处罚|chufa
没错|meicuo
其他|qita
我卡上|wokashang
淘票|taopiao
数码产品|shumachanpin
结交|jiejiao
充不进|chongbujin
认|ren
结|jie
法人|faren
点美团|dianmeituan
猫券放|maoquanfang
点着|dianzhao
为塞开|weisaikai
亿元|yiyuan
赎回|shuhui
寶嗎|baoma
邀请|yaoqing
车上|cheshang
中核|zhonghe
贷车|daiche
次款|cikuan
车贷|chedai
少换|shaohuan
上传|shangchuan
罚|fa
部|bu
怎以|zenyi
限制|xianzhi
气|qi
常期|changqi
加油站|jiayouzhan
油烟机|youyanji
我退|wotui
扣多|kouduo
al|al
里码|lima
要全|yaoquan
充钱进|chongqianjin
zhi|zhi
未换|weihuan
多充|duochong
波动|bodong
买货|maihuo
选怎用|xuanzenyong
妨碍|fangai
扣去|kouqu
结余|jieyu
环境|huanjing
有件|youjian
失|shi
63|63
离店|lidian
中华|zhonghua
货带|huodai
负钱|fuqian
画|hua
晚上|wanshang
减至|jianzhi
能待|nengdai
降下|jiangxia
看不到|kanbudao
负有|fuyou
货再点|huozaidian
那儿|naer
综合|zonghe
时有|shiyou
苏宁|suning
得多会|deduohui
对公|duigong
新装|xinzhuang
老凤祥|laofengxiang
无意之中|wuyizhizhong
三仟行|sanqianxing
单里|danli
星期二|xingqier
不夠|bugou
划入|huaru
账号|zhanghao
显示|xianshi
授信|shouxin
点不开|dianbukai
月末|yuemo
就入|jiuru
钱杂|qianza
相册|xiangce
堤显|dixian
王者|wangzhe
产生|chansheng
两三百|liangsanbai
一千多|yiqianduo
微信付|weixinfu
斗刷|doushua
部手机|bushouji
申通|shentong
金有|jinyou
扫钱码|saoqianma
会受|huishou
付额|fue
三毛|sanmao
有见|youjian
较|jiao
本用|benyong
出个|chuge
承受|chengshou
次数|cishu
制|zhi
介|jie
签到|qiandao
小店|xiaodian
只前|zhiqian
说卡|shuoka
扣卡|kouka
想得到|xiangdedao
删|shan
一吃|yichi
沙县|shaxian
板|ban
dd|dd
来不及|laibuji
找人|zhaoren
辈子|beizi
想着|xiangzhe
百分百|baifenbai
收|shou
咨询电话|zixundianhua
转发|zhuanfa
商品|shangpin
怎公|zengong
晚俩|wanlia
子|zi
烦人|fanren
零晨|lingchen
周一|zhouyi
相机|xiangji
商袋|shangdai
飘|piao
国航|guohang
过确|guoque
全期|quanqi
那家店|najiadian
九|jiu
一段时间|yiduanshijian
40|40
好换|haohuan
几百元|jibaiyuan
游戏币|youxibi
面对面|mianduimian
接下来|jiexialai
放到|fangdao
包括|baokuo
九期|jiuqi
主卡|zhuka
照旧|zhaojiu
挪|nuo
改在|gaizai
受限|shouxian
进不了|jinbuliao
待处理|daichuli
全民|quanmin
补差|bucha
几个|jige
继续|jixu
可伶领|kelingling
几批|jipi
一下|yixia
错过|cuoguo
不适|bushi
现实生活|xianshishenghuo
不当|budang
钱码|qianma
连用|lianyong
没动|meidong
地图|ditu
出帐|chuzhang
乘以|chengyi
能款|nengkuan
一再|yizai
样样|yangyang
五分|wufen
挽回|wanhui
收息|shouxi
预售|yushou
一双|yishuang
没调|meidiao
变无|bianwu
可靠|kekao
涨钱|zhangqian
提身|tishen
意期|yiqi
我怕|wopa
万率|wanlv
能多刷|nengduoshua
密碼|mima
能供|nenggong
减|jian
黄桃|huangtao
沒|mei
积分|jifen
记不住|jibuzhu
先能|xianneng
喔|o
huabei|huabei
瞒|man
无意|wuyi
美国|meiguo
减单|jiandan
员工|yuangong
泰国|taiguo
引想|yinxiang
需扣|xukou
充多|chongduo
交电|jiaodian
册消|cexiao
因微信|yinweixin
人死|rensi
国徽|guohui
怼|dui
世奇店|shiqidian
取出|quchu
我前|woqian
日过|riguo
减冻|jiandong
新|xin
计算公式|jisuangongshi
设|she
机会|jihui
高低|gaodi
好多天|haoduotian
青春|qingchun
谁|shei
前充|qianchong
调回|diaohui
改个|gaige
导致|daozhi
利息率|lixilv
香烟|xiangyan
没动静|meidongjing
指下|zhixia
华硕|huashuo
借不钱|jiebuqian
等于|dengyu
不合理|buheli
财富|caifu
裤子|kuzi
能进|nengjin
登入|dengru
十万|shiwan
打扰|darao
机制|jizhi
藏|cang
亚艺|yayi
关了机|guanleji
公能|gongneng
意在|yizai
手痒|shouyang
器能|qineng
全没|quanmei
我喃|wonan
能晚|nengwan
没想|meixiang
扣回去|kouhuiqu
咖能|kaneng
八十多|bashiduo
掏钱|taoqian
我点|wodian
八千多|baqianduo
全球|quanqiu
休闲|xiuxian
早日|zaori
摇在|yaozai
从天|congtian
来回|laihui
款晕|kuanyun
一月份|yiyuefen
布料|buliao
移出来|yichulai
减低|jiandi
借车|jieche
那货|nahuo
调高|diaogao
汽车票|qichepiao
有息|youxi
券换|quanhuan
制定|zhiding
回钱|huiqian
报名|baoming
锤子|chuizi
经常|jingchang
我刷|woshua
包裹|baoguo
电动车|diandongche
底线|dixian
匹配|pipei
自个|zige
网卡|wangka
多大|duoda
note|note
苏州|suzhou
把|ba
抢购|qianggou
调回去|diaohuiqu
问道|wendao
不往|buwang
借出去|jiechuqu
头疼|touteng
出借|chujie
元多|yuanduo
炒作|chaozuo
付密付|fumifu
二唯码|erweima
心寒|xinhan
中专生|zhongzhuansheng
额后|ehou
唯独|weidu
农行|nonghang
点收|dianshou
好会|haohui
没绑|meibang
赔付|peifu
交取|jiaoqu
盐|yan
厘|li
日至|rizhi
呗|bei
我天|wotian
io|io
减是|jianshi
免得|miande
牫|ge
排不上|paibushang
守信|shouxin
自己|ziji
码用|mayong
天美|tianmei
账慢|zhangman
优会|youhui
百分之|baifenzhi
我输|woshu
隔壁|gebi
长得|zhangde
没申|meishen
协议书|xieyishu
偶|ou
不换款|buhuankuan
没日|meiri
滚利|gunli
坚持|jianchi
一万五|yiwanwu
通知|tongzhi
订票|dingpiao
我以|woyi
逾越|yuyue
合钱|heqian
分用|fenyong
弄清|nongqing
已接|yijie
国泰|guotai
利率|lilv
这台|zhetai
pazs|pazs
未审核|weishenhe
按期|anqi
几小时|jixiaoshi
管不上|guanbushang
存储|cunchu
借成|jiecheng
备封|beifeng
脸用|lianyong
时能|shineng
多只|duozhi
再扣|zaikou
想存|xiangcun
客车|keche
温度|wendu
开得通|kaidetong
怎洋|zenyang
除了|chule
延拖|yantuo
最持|zuichi
比方说|bifangshuo
怎昵|zenni
疑惑|yihuo
没买|meimai
匆|cong
越来越|yuelaiyue
记入|jiru
份额|fene
重开|zhongkai
借花|jiehua
会何|huihe
再也不能|zaiyebuneng
套|tao
能设|nengshe
意兴|yixing
虚拟|xuni
还发|haifa
兴业银行|xingyeyinhang
那关|naguan
健|jian
还梦用|haimengyong
变回来|bianhuilai
快多|kuaiduo
改不|gaibu
手机费|shoujifei
发改|fagai
随着|suizhe
拉倒|ladao
祥情|xiangqing
空白|kongbai
付掉|fudiao
完工|wangong
通联|tonglian
贴高|tiegao
人收|renshou
不扣|bukou
店用|dianyong
能力|nengli
还交|haijiao
有能|youneng
成工|chenggong
生效|shengxiao
袜子|wazi
未安期|weianqi
衣|yi
元减|yuanjian
有名|youming
到期日|daoqiri
火车票|huochepiao
叶面|yemian
说次|shuoci
多期|duoqi
不进|bujin
迟疑|chiyi
去除|quchu
扣费能|koufeineng
转回|zhuanhui
of|of
提取|tiqu
抵|di
一位|yiwei
撒子|sazi
景|jing
虹彩|hongcai
交通流量|jiaotongliuliang
mah|mah
延伸|yanshen
一直|yizhi
吋|cun
失手|shishou
人家|renjia
di|di
那要|nayao
什停|shenting
去|qu
几千|jiqian
保|bao
音信|yinxin
睡着|shuizhao
抵用券|diyongquan
反复|fanfu
复机|fuji
再也|zaiye
身份证件|shenfenzhengjian
一个样|yigeyang
结核|jiehe
多应|duoying
没完|meiwan
借螞蟻|jiemayi
同用|tongyong
14|14
越期|yueqi
两万元|liangwanyuan
心愿|xinyuan
验正|yanzheng
农业银行|nongyeyinhang
很久用|henjiuyong
没事儿|meishier
归零|guiling
貌似|maosi
换新证|huanxinzheng
完用|wanyong
信息反馈|xinxifankui
自取|ziqu
手表|shoubiao
挑高|tiaogao
无缘无故|wuyuanwugu
会否|huifou
借本|jieben
嫂子|saozi
背停|beiting
扣年费|kounianfei
激费|jifei
一元|yiyuan
期买|qimai
长期有效|changqiyouxiao
09|09
説|shuo
换购|huangou
发生额|fashenge
钱表|qianbiao
点事|dianshi
说法|shuofa
极限|jixian
在|zai
冰箱|bingxiang
什回|shenhui
全面|quanmian
功能|gongneng
订个|dingge
特么|teme
有货|youhuo
能唤|nenghuan
秒杀|miaosha
天前|tianqian
≥|≥
我进|wojin
重启|chongqi
收线|shouxian
摇摇|yaoyao
过低|guodi
满意|manyi
那买|namai
留学|liuxue
已冻解|yidongjie
智能手机|zhinengshouji
天一|tianyi
下单|xiadan
老现|laoxian
说错|shuocuo
麻烦|mafan
明日|mingri
有何|youhe
多扣|duokou
能透|nengtou
现券|xianquan
时间段|shijianduan
负|fu
双重|shuangchong
人民银行|renminyinhang
老有|laoyou
小蜜蜂|xiaomifeng
还全|haiquan
回水|huishui
记账|jizhang
该乡|gaixiang
加速器|jiasuqi
有损|yousun
涉及|sheji
唄|bei
提醒|tixing
还久|haijiu
中学|zhongxue
转变|zhuanbian
到|dao
进货|jinhuo
办里|banli
会晚|huiwan
汽车贷款|qichedaikuan
备|bei
算钱|suanqian
本月|benyue
选好|xuanhao
逐步|zhubu
变办|bianban
开不来|kaibulai
而已|eryi
借货|jiehuo
无发|wufa
提作|tizuo
设走|shezou
小个|xiaoge
舍|she
上能|shangneng
还给|huangei
码刷|mashua
忘掉|wangdiao
问下会|wenxiahui
67|67
套装|taozhuang
安期|anqi
好乐迪|haoledi
人才|rencai
单立|danli
弄掉|nongdiao
提出申请|tichushenqing
灰复|huifu
日指|rizhi
冻接|dongjie
经办|jingban
笔能|bineng
我家|wojia
罚单|fadan
多笔|duobi
怎用|zenyong
san|san
二次|erci
下月会|xiayuehui
符合条件|fuhetiaojian
180|180
目的|mudi
好奇|haoqi
額度|edu
觉着|juezhe
身为|shenwei
刚是|gangshi
收矿|shoukuang
终生|zhongsheng
里弄|lilong
快递|kuaidi
vans|vans
再办|zaiban
整|zheng
万分之|wanfenzhi
分不低|fenbudi
搜索|sousuo
换位|huanwei
名下|mingxia
机有|jiyou
过久|guojiu
严重|yanzhong
普通|putong
十块钱|shikuaiqian
服装店|fuzhuangdian
好少|haoshao
借快|jiekuai
五百|wubai
下发|xiafa
咋整|zazheng
要常|yaochang
皮肤|pifu
五千多|wuqianduo
不梦|bumeng
kindle|kindle
绑卡时|bangkashi
买天|maitian
算息|suanxi
二十元|ershiyuan
机蜜|jimi
不过关|buguoguan
期再|qizai
五月|wuyue
刷脸|shualian
旅馆|lvguan
看清|kanqing
张券|zhangquan
我款|wokuan
里订|liding
连在一起|lianzaiyiqi
团团|tuantuan
换清马|huanqingma
退完|tuiwan
互通|hutong
收单|shoudan
码商|mashang
商户|shanghu
无言|wuyan
违章罚款|weizhangfakuan
人号|renhao
无条件|wutiaojian
付狂|fukuang
兑现|duixian
财付|caifu
抽到|choudao
明明|mingming
当|dang
下跪|xiagui
照顾|zhaogu
xiang|xiang
文凭|wenping
什呗|shenbei
抵扣|dikou
首|shou
肔|chi
给关|geiguan
旅游|lvyou
码蚁|mayi
证件照|zhengjianzhao
未买|weimai
审核|shenhe
认不出来|renbuchulai
费时间|feishijian
上期|shangqi
不现|buxian
不超|buchao
说|shuo
保存|baocun
多场|duochang
毛而|maoer
账日|zhangri
欠款人|qiankuanren
交上去|jiaoshangqu
61|61
本事|benshi
里领|liling
迟到|chidao
赚|zhuan
钻|zuan
补齐|buqi
道|dao
时效|shixiao
在线|zaixian
借高|jiegao
能免|nengmian
可回复|kehuifu
带息|daixi
何不|hebu
鞋要|xieyao
交摩拜|jiaomobai
换货|huanhuo
这部分|zhebufen
往期|wangqi
延误|yanwu
暂停|zanting
哪天出|natianchu
发票|fapiao
就近|jiujin
支什|zhishen
晚天|wantian
飞机|feiji
我分|wofen
卡内|kanei
海鲜店|haixiandian
这件|zhejian
不降|bujiang
多一点|duoyidian
缺让|querang
发觉|fajue
当月|dangyue
一句|yiju
彻底清除|chediqingchu
额买|emai
功例|gongli
八元|bayuan
降低|jiangdi
提迟|tichi
夜魔|yemo
＂|＂
不回|buhui
扣不扣|koubukou
曾额|cenge
内地|neidi
yib|yib
重先|zhongxian
来算|laisuan
关不了|guanbuliao
让|rang
边儿|bianer
真信|zhenxin
进|jin
摩|mo
id|id
积分换|jifenhuan
附加|fujia
转账|zhuanzhang
自助餐|zizhucan
手头|shoutou
嗷嗷|aoao
明月|mingyue
来要|laiyao
汕头|shantou
服|fu
信贷|xindai
商业银行|shangyeyinhang
找见|zhaojian
huab|huab
吾|wu
提出|tichu
三千多|sanqianduo
象|xiang
人为|renwei
加血|jiaxue
炸|zha
破|po
码由|mayou
信分|xinfen
蚂蚱|mazha
显视|xianshi
账清要|zhangqingyao
商店|shangdian
三四千|sansiqian
电影票|dianyingpiao
改钱|gaiqian
时收|shishou
张户|zhanghu
变大|bianda
几点|jidian
开回|kaihui
前一天|qianyitian
买楼|mailou
捐助|juanzhu
信息|xinxi
说活|shuohuo
不安|buan
湖北|hubei
有晚|youwan
psvr|psvr
设限|shexian
行用|xingyong
英文|yingwen
装后|zhuanghou
记得|jide
定额|dinge
用出|yongchu
正版|zhengban
四十多|sishiduo
门头照|mentouzhao
歉款|qiankuan
办新|banxin
之门|zhimen
借法|jiefa
今天下午|jintianxiawu
不给行|bugeixing
不吃|buchi
金币|jinbi
会下|huixia
借过款|jieguokuan
从额|conge
单期|danqi
范儿|faner
还涨|haizhang
安全可靠|anquankekao
赌钱|duqian
起码|qima
安全隐患|anquanyinhuan
刭|jing
号通|haotong
认为|renwei
编程|biancheng
有什用|youshenyong
正确|zhengque
不须|buxu
查下|chaxia
会迟|huichi
无需|wuxu
九千|jiuqian
堤前|diqian
集合|jihe
星期日|xingqiri
棉衣|mianyi
一会儿|yihuier
最优|zuiyou
分别|fenbie
用能|yongneng
但换|danhuan
接除|jiechu
理解|lijie
甚至|shenzhi
信号|xinhao
不知情|buzhiqing
授权人|shouquanren
签约|qianyue
均|jun
钓|diao
手术费|shoushufei
音响|yinxiang
享单|xiangdan
上个星期|shanggexingqi
商品质量|shangpinzhiliang
请查|qingcha
满|man
已满|yiman
这影|zheying
有奖|youjiang
一家|yijia
算法|suanfa
方能|fangneng
升成|shengcheng
用飞|yongfei
日结|rijie
邀请函|yaoqinghan
莫明|moming
款子|kuanzi
隔天|getian
呼|hu
专卖店|zhuanmaidian
医院|yiyuan
没事|meishi
玩想|wanxiang
撤款|chekuan
情况|qingkuang
从未|congwei
选用|xuanyong
商银|shangyin
怎米|zenmi
降降|jiangjiang
号夜|haoye
既有|jiyou
几蛮|jiman
滞纳金|zhinajin
勾选|gouxuan
宁时|ningshi
留在|liuzai
补能|buneng
人士|renshi
182|182
达|da
元时|yuanshi
完钱会|wanqianhui
来|lai
鹿城|lucheng
本能|benneng
学历证明|xuelizhengming
之前|zhiqian
催|cui
花能|huaneng
迪信通|dixintong
卖点|maidian
卡而|kaer
能办|nengban
出生|chusheng
二千元|erqianyuan
各付|gefu
星巴克|xingbake
浪费者|langfeizhe
拒绝|jujue
关下|guanxia
锤|chui
问下|wenxia
小商店|xiaoshangdian
四|si
大阪|daban
人来|renlai
天降|tianjiang
一摇到|yiyaodao
看过|kanguo
日会|rihui
摇钱|yaoqian
哪|na
至到|zhidao
推遲|tuichi
已付|yifu
z|z
首选|shouxuan
负度|fudu
运营|yunying
额杜|edu
有返|youfan
传到|chuandao
清账|qingzhang
二选|erxuan
卡中|kazhong
用口|yongkou
害|hai
己经|jijing
关吧|guanba
传错|chuancuo
两月|liangyue
交流|jiaoliu
回血|huixue
稍候|shaohou
日器|riqi
之间|zhijian
退出|tuichu
元账|yuanzhang
校验码|jiaoyanma
日午|riwu
否则|fouze
人多|renduo
更大些|gengdaxie
车|che
总数|zongshu
周生生|zhoushengsheng
消息|xiaoxi
购票|goupiao
三月份|sanyuefen
对话|duihua
非法|feifa
要什|yaoshen
网通|wangtong
138|138
宝贝|baobei
付现|fuxian
哪去|naqu
蓝领|lanling
完未|wanwei
好额|haoe
不太对|butaidui
加速|jiasu
效果|xiaoguo
时老有|shilaoyou
具体|juti
不能不|bunengbu
你查|nicha
影响|yingxiang
再换个|zaihuange
蛋糕|dangao
交给|jiaogei
实款|shikuan
变高|biangao
够确|gouque
环嘛|huanma
点接|dianjie
点变|dianbian
想改|xianggai
渠道|qudao
想换|xianghuan
变网|bianwang
132|132
能腐款|nengfukuan
按进|anjin
长到|zhangdao
开据|kaiju
从来|conglai
交水|jiaoshui
而|er
相信|xiangxin
那双|nashuang
换机|huanji
采用|caiyong
一给|yigei
解|jie
洗发|xifa
享机|xiangji
有所不同|yousuobutong
连同|liantong
语|yu
应有|yingyou
升级版|shengjiban
钱包|qianbao
借出来|jiechulai
付不起|fubuqi
蓝色|lanse
愉期|yuqi
门面|menmian
什么|shenme
退到|tuidao
信花|xinhua
路边摊|lubiantan
初中|chuzhong
发短信|faduanxin
五百多|wubaiduo
目|mu
支用|zhiyong
十一月|shiyiyue
不良后果|bulianghouguo
卡有|kayou
如家|rujia
口碑网|koubeiwang
∠|∠
两到|liangdao
淘友|taoyou
点才|diancai
通行证|tongxingzheng
共计|gongji
稀里糊涂|xilihutu
怎莫|zenmo
点交|dianjiao
扑蜂|pufeng
难借|nanjie
哭|ku
换分|huanfen
老不涨|laobuzhang
带款|daikuan
首开|shoukai
息费|xifei
包里|baoli
原额|yuane
升嘛|shengma
我杂|woza
后同|houtong
特惠|tehui
睡|shui
对办|duiban
卡交|kajiao
前不久|qianbujiu
听|ting
甜错|tiancuo
华润|huarun
遗失|yishi
前期|qianqi
逗|dou
计入|jiru
北|bei
有时|youshi
几时|jishi
却认|queren
良品|liangpin
过分|guofen
mmp|mmp
误填|wutian
复款|fukuan
剩额|shenge
下文|xiawen
面查|miancha
值钱|zhiqian
越来越少|yuelaiyueshao
附|fu
办过|banguo
颜值|yanzhi
英语|yingyu
汇款|huikuan
开销|kaixiao
合肥|hefei
体额|tie
骑行|qixing
东京|dongjing
一段|yiduan
十五天|shiwutian
交保|jiaobao
管它|guanta
开不开|kaibukai
价单|jiadan
如非|rufei
下钱|xiaqian
地方|difang
要交|yaojiao
还绩|haiji
卡解|kajie
入|ru
上存|shangcun
单数|danshu
奖卡|jiangka
划算|huasuan
返点|fandian
某笔|moubi
内购|neigou
元扣|yuankou
类似|leisi
这钱会|zheqianhui
改网商|gaiwangshang
举报|jubao
瞎加|xiajia
能缓|nenghuan
聪|cong
以直|yizhi
收付|shoufu
抽奖|choujiang
改是|gaishi
好多|haoduo
终止|zhongzhi
可更改|kegenggai
lo|lo
以邦定|yibangding
电影|dianying
增高|zenggao
特别|tebie
通信|tongxin
单项|danxiang
纸制|zhizhi
亚马逊|yamaxun
我久|wojiu
需用|xuyong
六选|liuxuan
dc|dc
完奖|wanjiang
卖主|maizhu
退票|tuipiao
总开|zongkai
这货|zhehuo
几多|jiduo
解控|jiekong
内个|neige
绑定|bangding
民办非|minbanfei
所花|suohua
二块钱|erkuaiqian
中断|zhongduan
风期|fengqi
可不|kebu
造成|zaocheng
提額|tie
红包码|hongbaoma
销户|xiaohu
很少|henshao
填表格|tianbiaoge
爱奇艺|aiqiyi
我应|woying
查完|chawan
远款|yuankuan
添加|tianjia
申额|shene
已经|yijing
们|men
放着不用|fangzhebuyong
唤起|huanqi
陌生|mosheng
小红|xiaohong
半|ban
易|yi
动态|dongtai
扣|kou
损害|sunhai
参数|canshu
分高|fengao
外地|waidi
确退|quetui
一去|yiqu
虽然|suiran
阻止|zuzhi
售后服务|shouhoufuwu
细节|xijie
昨晚|zuowan
关有|guanyou
上卡|shangka
长额服|zhangefu
三期|sanqi
小鱼|xiaoyu
扫龙|saolong
时刻|shike
倒|dao
会操|huicao
换枪|huanqiang
九十六|jiushiliu
花通|huatong
输款|shukuan
多钱少|duoqianshao
结是|jieshi
封住|fengzhu
按日算|anrisuan
日超|richao
变为|bianwei
能冲|nengchong
用闲鱼|yongxianyu
优惠|youhui
团里|tuanli
淘宝网|taobaowang
有邦定|youbangding
根改|gengai
试|shi
包烟|baoyan
又关|youguan
起步|qibu
能美团|nengmeituan
电瓶车|dianpingche
货退|huotui
回国|huiguo
还轻|haiqing
支麻|zhima
太紧|taijin
钱进|qianjin
倒霉|daomei
买东|maidong
第四条|disitiao
够用|gouyong
风控冲|fengkongchong
长高|zhanggao
差一点|chayidian
能清|nengqing
全扣|quankou
额快|ekuai
沟通|goutong
结款|jiekuan
高德|gaode
六十岁|liushisui
写少|xieshao
解帮|jiebang
货在|huozai
机密|jimi
江干|jianggan
仓储|cangchu
135|135
皮衣|piyi
喵|miao
首月|shouyue
关蔽|guanbi
没货后|meihuohou
花个|huage
套路|taolu
冰结|bingjie
怀孕|huaiyun
解决办法|jiejuebanfa
开小|kaixiao
感|gan
举个|juge
理发店|lifadian
收获|shouhuo
五号|wuhao
只收|zhishou
递减|dijian
缴小|jiaoxiao
一個|yige
读|du
佣金|yongjin
会放|huifang
检验|jianyan
货已|huoyi
剩余|shengyu
什会|shenhui
扣款|koukuan
游泳|youyong
拒|ju
买入|mairu
初始|chushi
宿迁|suqian
茌|chi
容许|rongxu
不升额|bushenge
代缴|daijiao
刚修|gangxiu
两块|liangkuai
有笔|youbi
日气|riqi
入口|rukou
取肖|quxiao
确借|quejie
样子|yangzi
取额|que
用过|yongguo
希望|xiwang
生源|shengyuan
邮储|youchu
小蓝|xiaolan
出卖|chumai
那多|naduo
充错|chongcuo
除|chu
停止|tingzhi
不哈|buha
据说|jushuo
周期|zhouqi
天猫分|tianmaofen
几倍|jibei
三样|sanyang
保里|baoli
阵子|zhenzi
可刷|keshua
打出|dachu
十五六|shiwuliu
重行|chongxing
已尽|yijin
月初|yuechu
钱坏|qianhuai
支付宝|zhifubao
相似|xiangsi
啮|nie
钱划|qianhua
副作用|fuzuoyong
如花|ruhua
进入|jinru
加高|jiagao
调过|diaoguo
工作日内|gongzuorinei
直|zhi
比|bi
加起|jiaqi
綁定|bangding
总买|zongmai
19|19
借一|jieyi
拖|tuo
陌生人|moshengren
千|qian
一向|yixiang
另|ling
65|65
手里|shouli
介绍|jieshao
c|c
帮人|bangren
第二第三|dierdisan
四期|siqi
多长时间|duozhangshijian
发放|fafang
限次|xianci
人面|renmian
上美团|shangmeituan
大笔|dabi
干什么|ganshenme
计次|jici
变一|bianyi
二十多块|ershiduokuai
怎解|zenjie
要发|yaofa
账进|zhangjin
跟本|genben
听歌|tingge
介面|jiemian
票票|piaopiao
附近|fujin
完钱|wanqian
挖宝|wabao
修复|xiufu
下买|xiamai
以后|yihou
借时|jieshi
出后|chuhou
进而|jiner
禁|jin
问密付|wenmifu
期费|qifei
接入|jieru
一万多|yiwanduo
有意|youyi
我原|woyuan
替换成|tihuancheng
臭|chou
未清|weiqing
切找|qiezhao
不久|bujiu
多点|duodian
固话|guhua
中不借|zhongbujie
小商贩|xiaoshangfan
最终|zuizhong
摇一摇才|yaoyiyaocai
vivo|vivo
说代|shuodai
先转|xianzhuan
店面|dianmian
单天|dantian
每人每天|meirenmeitian
单要|danyao
每一件|meiyijian
却是|queshi
两千多块|liangqianduokuai
保定|baoding
气费|qifei
上当|shangdang
綁|bang
hellobike|hellobike
膏|gao
没花用|meihuayong
只右|zhiyou
度作|duzuo
外来|wailai
免除|mianchu
称|cheng
再能|zaineng
财单|caidan
翔|xiang
超消费|chaoxiaofei
申请人|shenqingren
封顶|fengding
已經|yijing
申花|shenhua
什冻|shendong
广发|guangfa
新闻|xinwen
倩女|qiannv
名额|minge
点心|dianxin
加气|jiaqi
九号|jiuhao
二百块|erbaikuai
恐吓|konghe
有免|youmian
改回开|gaihuikai
省份|shengfen
划分|huafen
户口本|hukouben
俩次|liaci
好像|haoxiang
证明|zhengming
纸质|zhizhi
搞不清|gaobuqing
必|bi
后到|houdao
好几百元|haojibaiyuan
码是|mashi
十月初|shiyuechu
弹窗|danchuang
拜|bai
怎么弄|zenmenong
刮|gua
后想|houxiang
选择性|xuanzexing
这去|zhequ
大昌|dachang
客页|keye
销号|xiaohao
儿童|ertong
基本上|jibenshang
同笔|tongbi
符合|fuhe
貝是|beishi
启消|qixiao
换算|huansuan
一领|yiling
条款|tiaokuan
容|rong
掉下来|diaoxialai
浦发|pufa
直有|zhiyou
专家|zhuanjia
花款|huakuan
输入|shuru
可转|kezhuan
月利率|yuelilv
一毛钱|yimaoqian
提期|tiqi
前能|qianneng
一说|yishuo
分个|fenge
现想|xianxiang
当中|dangzhong
算是|suanshi
付额会|fuehui
没月|meiyue
使用量|shiyongliang
装修|zhuangxiu
出手|chushou
假|jia
三倍|sanbei
未结算|weijiesuan
纸尿裤|zhiniaoku
置顶|zhiding
她|ta
建行|jianhang
会要|huiyao
实物|shiwu
收费|shoufei
还货|haihuo
cnm|cnm
用下|yongxia
钱减|qianjian
货用|huoyong
木有|muyou
再有|zaiyou
肖费|xiaofei
认真|renzhen
没想用|meixiangyong
曾|ceng
还息|haixi
哥|ge
期来|qilai
皮鞋|pixie
货好|huohao
鸡蛋|jidan
退多能|tuiduoneng
绝对|juedui
取缔|qudi
电话卡|dianhuaka
改呀|gaiya
风险|fengxian
为付|weifu
卡扣|kakou
交通卡|jiaotongka
一回|yihui
身亡|shenwang
优费|youfei
栋结|dongjie
切回|qiehui
大点|dadian
信用卡|xinyongka
码嘛|mama
头|tou
店主|dianzhu
扣起|kouqi
赠送|zengsong
八九月|bajiuyue
我摇到|woyaodao
底下|dixia
直降|zhijiang
横杠|henggang
升级|shengji
不先扣|buxiankou
一中|yizhong
飞猪订|feizhuding
长|zhang
158|158
从试|congshi
商用|shangyong
以点|yidian
高是|gaoshi
蒋|jiang
怎弄|zennong
好多钱|haoduoqian
用多|yongduo
乐|le
五天|wutian
改变|gaibian
去何|quhe
电费|dianfei
完整|wanzheng
大件|dajian
付期|fuqi
提起|tiqi
算|suan
查不出|chabuchu
评|ping
点算|diansuan
用新开|yongxinkai
几星|jixing
穷|qiong
交通银行|jiaotongyinhang
大麦|damai
还倩倩|haiqianqian
说涨|shuozhang
超过|chaoguo
候能|houneng
当天|dangtian
关问|guanwen
付多|fuduo
税|shui
限于|xianyu
聊|liao
刷机|shuaji
早餐券|zaocanquan
单款|dankuan
不得|bude
厂品|changpin
开展业务|kaizhanyewu
剩|sheng
冲到|chongdao
一单|yidan
廷期|tingqi
追回来|zhuihuilai
来看|laikan
停扣|tingkou
全收|quanshou
使得|shide
休改|xiugai
没用|meiyong
业多|yeduo
会现|huixian
东东|dongdong
双|shuang
订金|dingjin
脸时|lianshi
小心|xiaoxin
一块儿|yikuaier
理|li
口除|kouchu
割|ge
款有|kuanyou
正试|zhengshi
最低|zuidi
同个|tongge
现费|xianfei
一俩|yilia
服务|fuwu
钱卡|qianka
用旧|yongjiu
租错|zucuo
栓|shuan
分多|fenduo
经捉|jingzhuo
几号|jihao
冲减|chongjian
问得|wende
没什|meishen
喝晕|heyun
买下来|maixialai
几样|jiyang
买菜|maicai
那方付|nafangfu
调到|diaodao
时花|shihua
刷单|shuadan
泥|ni
控款|kongkuan
没车|meiche
星期一|xingqiyi
伤心|shangxin
期返款|qifankuan
qian|qian
付小蓝|fuxiaolan
调降|diaojiang
圣诞节|shengdanjie
叶|ye
91|91
什是|shenshi
之借|zhijie
分月|fenyue
花别|huabie
哪收|nashou
请间|qingjian
够物|gouwu
会补|huibu
想交|xiangjiao
说满|shuoman
货未|huowei
以天|yitian
三分之一|sanfenzhiyi
征西|zhengxi
房产|fangchan
爸|ba
一零|yiling
手贱|shoujian
能查|nengcha
没选|meixuan
几岁|jisui
元进|yuanjin
形式|xingshi
捐赠|juanzeng
抠款|koukuan
不便|bubian
内前|neiqian
卡过|kaguo
具备|jubei
外商|waishang
度少|dushao
先后|xianhou
需有|xuyou
调高些|diaogaoxie
坐车|zuoche
过要|guoyao
数能|shuneng
更新|gengxin
中等|zhongdeng
邻|lin
化妆品|huazhuangpin
微钱|weiqian
一样|yiyang
有降|youjiang
随和|suihe
开店|kaidian
起止|qizhi
出不来|chubulai
大学|daxue
包含|baohan
没笔|meibi
十分之一|shifenzhiyi
妹妹|meimei
余|yu
史用|shiyong
还降|haijiang
帐面|zhangmian
回提|huiti
升到|shengdao
房惠用|fanghuiyong
多大下|duodaxia
我够|wogou
功能障碍|gongnengzhangai
蓝|lan
不加分|bujiafen
禁止|jinzhi
十二时|shiershi
费是|feishi
十|shi
请客|qingke
地能|deneng
六月|liuyue
四月|siyue
凭证|pingzheng
咋天|zatian
会扣|huikou
傣妹|daimei
充摩拜|chongmobai
趣|qu
石化|shihua
黄钻|huangzuan
征给|zhenggei
魅蓝|meilan
收集|shouji
看不懂|kanbudong
话费|huafei
微货|weihuo
我新办|woxinban
镸|chang
描红|miaohong
偶尔|ouer
丢|diu
现款|xiankuan
咋作|zazuo
管理|guanli
没人扣|meirenkou
怎|zen
里定|liding
额太低|etaidi
刚来|ganglai
完额|wane
账得|zhangde
连锁店|liansuodian
支|zhi
父母|fumu
工商银行|gongshangyinhang
钱传|qianchuan
收不起|shoubuqi
号付|haofu
水平|shuiping
挣到|zhengdao
铺子|puzi
文盲|wenmang
包包|baobao
教程|jiaocheng
货都|huodou
注重|zhuzhong
zhebi|zhebi
那负|nafu
收入|shouru
没订|meiding
还会口|haihuikou
批|pi
转卡|zhuanka
调增|diaozeng
两三天|liangsantian
可延长|keyanchang
任为|renwei
拆出|chaichu
期钱|qiqian
今个|jinge
利滚利|ligunli
迷你|mini
不成|bucheng
激话|jihua
不能取消|bunengquxiao
迟迟|chichi
先花|xianhua
如加|rujia
达尔|daer
冲账|chongzhang
逼|bi
tm|tm
日前|riqian
红包|hongbao
太底|taidi
还消|haixiao
数么|shume
扣有|kouyou
撤销|chexiao
人人|renren
大型商场|daxingshangchang
没够|meigou
多额|duoe
本今|benjin
扫不上|saobushang
卡代|kadai
伙伴|huoban
乱收|luanshou
支撑|zhicheng
这卡能|zhekaneng
少扣|shaokou
详|xiang
垃圾|laji
行不通|xingbutong
怎不扣|zenbukou
蔡能|caineng
体系|tixi
家中|jiazhong
徽|hui
点到|diandao
刚付|gangfu
久款|jiukuan
咋子|zazi
刷刷|shuashua
摩托|motuo
会查|huicha
二千多|erqianduo
保持|baochi
充进|chongjin
本到|bendao
可买|kemai
今天|jintian
买物|maiwu
涨涨|zhangzhang
原数|yuanshu
代不|daibu
来开|laikai
榨汁机|zhazhiji
领导|lingdao
多天|duotian
能移|nengyi
算点|suandian
眼镜店|yanjingdian
低得|dide
只发|zhifa
特殊|teshu
莫名|moming
分成|fencheng
点会|dianhui
还本|huanben
在建|zaijian
难开|nankai
足记|zuji
yy|yy
户|hu
信益|xinyi
券找|quanzhao
老子|laozi
入到|rudao
经用|jingyong
不明|buming
两部|liangbu
钱确|qianque
用此|yongci
可钱|keqian
卡会|kahui
会收|huishou
批准|pizhun
收超|shouchao
越用越少|yueyongyueshao
抠|kou
已够|yigou
换不上|huanbushang
码收|mashou
卡问|kawen
我充|wochong
不过|buguo
易懂|yidong
发用|fayong
尼玛|nima
贡茶|gongcha
打码|dama
珊除|shanchu
合在一起|hezaiyiqi
何种|hezhong
无度|wudu
临县|linxian
成|cheng
美国银行|meiguoyinhang
想领|xiangling
怎不涨|zenbuzhang
改下|gaixia
符合标准|fuhebiaozhun
搬里|banli
改名|gaiming
免税店|mianshuidian
收戗|shouqiang
度调|dudiao
五期|wuqi
离|li
小蓝车|xiaolanche
付不款|fubukuan
宝卡|baoka
里查|licha
拍小|paixiao
日包|ribao
抠门|koumen
安装|anzhuang
铂金|bojin
退货|tuihuo
不可抗力|bukekangli
恢复期|huifuqi
借不借|jiebujie
借期|jieqi
飞机票|feijipiao
没定|meiding
蜜付|mifu
透额|toue
清掉|qingdiao
窗|chuang
真的|zhende
算不来|suanbulai
到期|daoqi
追|zhui
五次|wuci
查单|chadan
正|zheng
瞬间|shunjian
升网商|shengwangshang
为准|weizhun
降完|jiangwan
tv|tv
上发|shangfa
投影仪|touyingyi
逗人|douren
气死我了|qisiwole
时多|shiduo
卡卡|kaka
关连|guanlian
错账|cuozhang
麦当劳|maidanglao
坏款|huaikuan
一两万|yiliangwan
里划|lihua
商是|shangshi
用餐|yongcan
少用|shaoyong
并存|bingcun
送货|songhuo
中借|zhongjie
yaoyue|yaoyue
时才|shicai
半夜|banye
却领|queling
老往|laowang
运费|yunfei
忙碌|manglu
智力|zhili
网络延时|wangluoyanshi
几次|jici
频道|pindao
阖家|hejia
换会|huanhui
急用|jiyong
欠费|qianfei
张家口|zhangjiakou
率息|lvxi
犹疑|youni
天能|tianneng
会息罚|huixifa
刷来|shualai
老|lao
很久|henjiu
错|cuo
一笔|yibi
晚些|wanxie
如下|ruxia
扣掉|koudiao
电卷|dianjuan
要关|yaoguan
37|37
保障|baozhang
更欢|genghuan
多好|duohao
照片|zhaopian
邮箱地址|youxiangdizhi
重现|chongxian
黑色|heise
堤|di
空调|kongtiao
自动更新|zidonggengxin
顺风|shunfeng
课胡|kehu
指引|zhiyin
办别|banbie
想换个|xianghuange
偷刷|toushua
年度|niandu
′|′
一个劲|yigejin
资金周转|zijinzhouzhuan
车辆|cheliang
化唄|huabei
尚艺|shangyi
划走|huazou
网上银行|wangshangyinhang
问是|wenshi
申和|shenhe
含有|hanyou
期现|qixian
美团用|meituanyong
为您服务|weininfuwu
怎退|zentui
原理|yuanli
并|bing
欧元|ouyuan
不让|burang
他行|taxing
存多|cunduo
周大福|zhoudafu
还照|haizhao
查钱|chaqian
天麻|tianma
强制性|qiangzhixing
批扣|pikou
瞪|deng
那前|naqian
禁用|jinyong
条裤|tiaoku
后冲|houchong
钱先|qianxian
元力|yuanli
杳询|yaoxun
初始状态|chushizhuangtai
降到|jiangdao
呐换|nahuan
暂未|zanwei
后期|houqi
消号|xiaohao
下能|xianeng
拍卖|paimai
从少|congshao
实际|shiji
管闭|guanbi
合为|hewei
是否|shifou
转门|zhuanmen
美团|meituan
可能|keneng
佳乐家|jialejia
过段时间|guoduanshijian
锁住|suozhu
答复|dafu
有效|youxiao
会得用|huideyong
如期|ruqi
这买个|zhemaige
登录|denglu
用超|yongchao
今|jin
等|deng
能定|nengding
发要|fayao
能教|nengjiao
做过|zuoguo
ipad|ipad
给定|geiding
宝贵|baogui
emmmm|emmmm
账期|zhangqi
账到|zhangdao
全关|quanguan
撩|liao
否定|fouding
八|ba
黄金首饰|huangjinshoushi
买米|maimi
一切|yiqie
溜冰鞋|liubingxie
莫有|moyou
提到|tidao
授权点|shouquandian
相应|xiangying
墙壁|qiangbi
设到|shedao
截屏|jieping
我操|wocao
中买|zhongmai
世|shi
很长|henzhang
干脆|gancui
有事吗|youshima
协商|xieshang
货物|huowu
玩笑|wanxiao
补办|buban
还木有|haimuyou
函是|hanshi
冰激凌|bingjiling
盼达|panda
顾客|guke
提额充|tiechong
借会降|jiehuijiang
境外游|jingwaiyou
wap|wap
用不上|yongbushang
家庭|jiating
完关|wanguan
推|tui
条形码|tiaoxingma
那借|najie
全都|quandou
笔后|bihou
立即|liji
杂|za
刚|gang
水果店|shuiguodian
路|lu
几点钟|jidianzhong
常事|changshi
发不出|fabuchu
邻居|linju
万家|wanjia
能付|nengfu
元联|yuanlian
多上|duoshang
要选|yaoxuan
多一半|duoyiban
能刷|nengshua
损额|sune
大大|dada
款待|kuandai
原|yuan
注销|zhuxiao
第借|dijie
数目|shumu
时想|shixiang
钱算|qiansuan
元要|yuanyao
成天|chengtian
生活|shenghuo
增减|zengjian
中国工商银行|zhongguogongshangyinhang
分笔|fenbi
他家|tajia
改签|gaiqian
现示|xianshi
作用|zuoyong
输|shu
已坏|yihuai
号款|haokuan
利金|lijin
延缓|yanhuan
额为|ewei
元宝|yuanbao
说明|shuoming
杂算|zasuan
小二|xiaoer
之分|zhifen
没全|meiquan
鱼网|yuwang
付歌|fuge
怎木|zenmu
唄用|beiyong
显时|xianshi
着急|zhaoji
查封|chafeng
怎可|zenke
正信|zhengxin
很多年|henduonian
我整|wozheng
银卡钱|yinkaqian
口碑|koubei
下次|xiaci
蚂议|mayi
按年|annian
几分|jifen
程|cheng
关必|guanbi
货想|huoxiang
估清|guqing
积极|jiji
电商|dianshang
业务|yewu
付实款|fushikuan
回收|huishou
是期|shiqi
文易|wenyi
调理|tiaoli
我宁外|woningwai
52|52
年头|niantou
浏览|liulan
自定义|zidingyi
∽|∽
咱办|zanban
推过|tuiguo
退除|tuichu
满屏|manping
只退|zhitui
可领|keling
长付|zhangfu
介意|jieyi
换约|huanyue
关联方|guanlianfang
还素|haisu
理培|lipei
分付|fenfu
i|i
扫码|saoma
支付|zhifu
oo|oo
冰柜|binggui
我码|woma
分不开|fenbukai
激活码|jihuoma
缺用|queyong
未使|weishi
有网|youwang
小蜜|xiaomi
前后|qianhou
确保|quebao
购是|goushi
面冲|mianchong
用行|yongxing
旅社|lvshe
近情|jinqing
需借|xujie
一步|yibu
手机店|shoujidian
太多会|taiduohui
日能|rineng
时而|shier
出不出|chubuchu
个用|geyong
十二月|shieryue
发呗|fabei
年级|nianji
不同点|butongdian
放钱|fangqian
五十多|wushiduo
过户|guohu
来记|laiji
付摩拜|fumobai
最多花|zuiduohua
要输|yaoshu
开密付|kaimifu
调控|tiaokong
死皮赖脸|sipilailian
证书|zhengshu
跟风|genfeng
吓|xia
用美团|yongmeituan
手书|shoushu
存费|cunfei
今年|jinnian
重付|zhongfu
终端|zhongduan
137|137
点点|diandian
购用|gouyong
庆卡|qingka
大王|daiwang
想询|xiangxun
上|shang
等级|dengji
一人能|yirenneng
隔|ge
还光|haiguang
曼网|manwang
金是|jinshi
住房|zhufang
起点|qidian
发完|fawan
有下|youxia
天猫付|tianmaofu
帮别|bangbie
假设|jiashe
认证|renzheng
商量|shangliang
别用|bieyong
笔是|bishi
借不起|jiebuqi
辆|liang
会多收|huiduoshou
变认|bianren
网商货|wangshanghuo
采集|caiji
減息|jianxi
哪充|nachong
领优酷|lingyouku
负债|fuzhai
快用|kuaiyong
持有|chiyou
退会|tuihui
实时|shishi
我关|woguan
改来改去|gailaigaiqu
空然|kongran
怎会记|zenhuiji
没冲|meichong
搜|sou
误操作|wucaozuo
飞猪|feizhu
越|yue
能迟|nengchi
单退|dantui
neng|neng
健康|jiankang
手继费|shoujifei
生意|shengyi
前退|qiantui
证都|zhengdou
不要|buyao
开没开|kaimeikai
花坝|huaba
日息|rixi
弄错|nongcuo
仍旧|rengjiu
k|k
领兑|lingdui
满足|manzu
还通|haitong
后百变|houbaibian
看脸|kanlian
事多|shiduo
总供|zonggong
上线|shangxian
没出|meichu
记录仪|jiluyi
尝试|changshi
工|gong
封号|fenghao
任|ren
云上|yunshang
花嘛|huama
蚁族|yizu
小米|xiaomi
qua|qua
pc|pc
无名|wuming
查收|chashou
延到|yandao
绑卡|bangka
微笑|weixiao
柱|zhu
混|hun
出口|chukou
哪里找|nalizhao
不错|bucuo
现用|xianyong
鬼脸|guilian
万元|wanyuan
不管|buguan
刷掉|shuadiao
一个五百|yigewubai
的士|dishi
解度|jiedu
初中文化|chuzhongwenhua
虎牙|huya
款额|kuane
分给|fengei
毛钱|maoqian
月息|yuexi
何时|heshi
商铺|shangpu
用微|yongwei
当初|dangchu
laigufe|laigufe
我剛|wogang
埠子|buzi
互相|huxiang
备足|beizu
压金去|yajinqu
先退|xiantui
冻洁|dongjie
出错|chucuo
体统|titong
更好|genghao
看满|kanman
欢庆|huanqing
个人用户|gerenyonghu
献爱心|xianaixin
运营商|yunyingshang
前未|qianwei
你们好|nimenhao
用|yong
车票|chepiao
有发|youfa
单一|danyi
新卡|xinka
付现金|fuxianjin
理面|limian
所在|suozai
因填错|yintiancuo
我秀豆|woxiudou
迟延|chiyan
瓜子|guazi
浪琴|langqin
花叭|huaba
有月费|youyuefei
价钱|jiaqian
电话费|dianhuafei
比喻|biyu
時候|shihou
没太懂|meitaidong
售假|shoujia
三四个|sansige
撤回|chehui
三分钟|sanfenzhong
几十|jishi
缩减|suojian
搞不清楚|gaobuqingchu
人员|renyuan
除外|chuwai
流水号|liushuihao
降成|jiangcheng
花清|huaqing
回来|huilai
能连本|nenglianben
直播|zhibo
七十块|qishikuai
不帮|bubang
通融|tongrong
没钱少|meiqianshao
多谢|duoxie
忠实|zhongshi
五元|wuyuan
后面|houmian
会封|huifeng
加息|jiaxi
不变|bubian
默认|moren
共有|gongyou
漏|lou
定好|dinghao
任意|renyi
网购|wanggou
亚航|yahang
我定|woding
清除|qingchu
降零|jiangling
经|jing
uu|uu
要不了|yaobule
完款|wankuan
这鞋|zhexie
没置|meizhi
回扣|huikou
守|shou
抢救|qiangjiu
回事|huishi
这天|zhetian
猛|meng
十五号|shiwuhao
十日|shiri
庄园|zhuangyuan
拿走|nazou
咖啡|kafei
马上会|mashanghui
票到|piaodao
帐号密码|zhanghaomima
乡下|xiangxia
乘坐|chengzuo
天给|tiangei
露个|luge
面找|mianzhao
用以|yongyi
脸过|lianguo
还会降|haihuijiang
通没|tongmei
用脸|yonglian
数量|shuliang
查对|chadui
卸掉|xiediao
核实|heshi
付息|fuxi
美团券|meituanquan
安安|anan
没增|meizeng
抵掉|didiao
恢复原|huifuyuan
勇|yong
份面|fenmian
平常|pingchang
没个|meige
唄額度|beiedu
显未|xianwei
换作|huanzuo
领去|lingqu
买件|maijian
受不受|shoubushou
两家|liangjia
夸有|kuayou
不返|bufan
直充|zhichong
曼都店|mandoudian
群子|qunzi
专到|zhuandao
开看|kaikan
多钱|duoqian
买房|maifang
保护|baohu
信个|xinge
转网|zhuanwang
保护区|baohuqu
如未|ruwei
快退|kuaitui
钱己|qianji
叫唤|jiaohuan
毙|bi
依次|yici
付电|fudian
大多数|daduoshu
错话|cuohua
惠思家|huisijia
会降|huijiang
刚换|ganghuan
收到|shoudao
再刷|zaishua
准入|zhunru
转去|zhuanqu
节假日|jiejiari
六天|liutian
收四白|shousibai
贷会|daihui
劳资|laozi
其前|qiqian
详细情况|xiangxiqingkuang
网贷商|wangdaishang
管|guan
同一个|tongyige
支金|zhijin
扫美团|saomeituan
适合|shihe
赶过去|ganguoqu
未扣|weikou
解除|jiechu
关上|guanshang
转出|zhuanchu
因银|yinyin
利自是|lizishi
但用|danyong
起算日|qisuanri
助手|zhushou
信征|xinzheng
一面|yimian
叩上|koushang
能扣|nengkou
有点|youdian
消费者|xiaofeizhe
快餐|kuaican
忽然|huran
我换个|wohuange
完借|wanjie
扣减额|koujiane
更大|gengda
宽限期|kuanxianqi
解析|jiexi
油卡|youka
04|04
逾期|yuqi
乙关|yiguan
小票|xiaopiao
胀气|zhangqi
先换|xianhuan
补上|bushang
扫图|saotu
线|xian
卡死|kasi
酒|jiu
不取|buqu
扣钱|kouqian
没咯|meige
半刚|bangang
够|gou
总借|zongjie
空号|konghao
定餐|dingcan
钱会少|qianhuishao
扣日|kouri
考虑|kaolv
保证|baozheng
还壳款|haikekuan
评级|pingji
费钱|feiqian
涨分|zhangfen
退押|tuiya
时官|shiguan
涨过|zhangguo
溢出|yichu
分着|fenzhe
嗨|hai
这月分|zheyuefen
能调|nengdiao
摇一摇|yaoyiyao
没见|meijian
两批|liangpi
一周|yizhou
燃气|ranqi
万年|wannian
宜黄县|yihuangxian
有什麼|youshenme
无奈|wunai
七个|qige
充成|chongcheng
五|wu
欠款|qiankuan
二日|erri
毎|mei
抽奖券|choujiangquan
总需|zongxu
将近|jiangjin
抽返|choufan
够不够|goubugou
下午|xiawu
起能|qineng
变小|bianxiao
个体|geti
通信录|tongxinlu
符号|fuhao
找靓|zhaojing
点不动|dianbudong
卷|juan
二百多|erbaiduo
百分之四|baifenzhisi
并未|bingwei
一它|yita
合适|heshi
贷款人|daikuanren
那里|nali
扣会|kouhui
第二|dier
翻番|fanfan
认出|renchu
填行成|tianxingcheng
危险|weixian
我想领|woxiangling
贷能|daineng
领走|lingzou
传|chuan
运险费|yunxianfei
预受|yushou
太大|taida
他妈的|tamade
用安卓|yonganzhuo
我报|wobao
没得|meide
号充|haochong
评定|pingding
返卷|fanjuan
选|xuan
联合|lianhe
当期|dangqi
款|kuan
我见|wojian
充点|chongdian
还充|haichong
好了吗|haolema
时装|shizhuang
咋个|zage
一月底|yiyuedi
宝安|baoan
你常|nichang
利近息|lijinxi
开得|kaide
一千多元|yiqianduoyuan
上行|shangxing
转入|zhuanru
分值|fenzhi
前个|qiange
开花|kaihua
金服|jinfu
扣俩|koulia
我输错|woshucuo
而变|erbian
纷争|fenzheng
填写|tianxie
绳子|shengzi
限时|xianshi
网龙|wanglong
短租|duanzu
登不进|dengbujin
转不入|zhuanburu
ze|ze
消失掉|xiaoshidiao
爸爸|baba
题高|tigao
点开|diankai
alini|alini
事件|shijian
二三个|ersange
停掉|tingdiao
录用|luyong
帮帮忙|bangbangmang
二三|ersan
另外|lingwai
远|yuan
退得|tuide
要紧|yaojin
额才|ecai
学位|xuewei
请教|qingjiao
日往|riwang
网上商城|wangshangshangcheng
内要|neiyao
申清|shenqing
长时间|zhangshijian
够买|goumai
交清|jiaoqing
邮到|youdao
花用|huayong
点取|dianqu
十来天|shilaitian
解封|jiefeng
商行|shanghang
那有条|nayoutiao
码后|mahou
预付|yufu
块|kuai
分可|fenke
理论|lilun
积攒|jizan
期货|qihuo
敬请|jingqing
过往|guowang
期期|qiqi
有礼息|youlixi
改点|gaidian
里|li
生请|shengqing
开奖|kaijiang
自幼|ziyou
十六周岁|shiliuzhousui
不放钱|bufangqian
要升|yaosheng
洁清|jieqing
沒用|meiyong
規則|guize
纳闷|namen
问过|wenguo
记着|jizhe
修改|xiugai
这必|zhebi
好外|haowai
五折|wuzhe
不住|buzhu
成分|chengfen
升请|shengqing
有|you
寄给|jigei
币用|biyong
购物单|gouwudan
号关|haoguan
真|zhen
借来|jielai
兑换券|duihuanquan
结请|jieqing
团购|tuangou
第三天|disantian
民间|minjian
网商带|wangshangdai
集分宝|jifenbao
还得起|haideqi
收多贷|shouduodai
忘好|wanghao
批量|piliang
换开|huankai
社会|shehui
降价|jiangjia
哪付|nafu
借备|jiebei
美团动|meituandong
手|shou
疯|feng
共亨|gongheng
学数|xueshu
周日|zhouri
苏果超市|suguochaoshi
缴错|jiaocuo
拍拍|paipai
采源宝|caiyuanbao
如向何|ruxianghe
马姨|mayi
第一天|diyitian
少钱|shaoqian
弄清楚|nongqingchu
退定|tuiding
取件|qujian
我于|woyu
一两|yiliang
花得|huade
偶想|ouxiang
怩|ni
想家|xiangjia
商品交易|shangpinjiaoyi
休息|xiuxi
总叫|zongjiao
半价|banjia
牵连|qianlian
回比|huibi
分来|fenlai
应用|yingyong
伎|ji
出去|chuqu
两会|lianghui
没带|meidai
收取|shouqu
卡付|kafu
点不上|dianbushang
負|fu
问|wen
悦客|yueke
屏幕|pingmu
苹果公司|pingguogongsi
四十天|sishitian
流水|liushui
绑|bang
第一次|diyici
新新|xinxin
放进|fangjin
网址|wangzhi
附和|fuhe
用电|yongdian
交通|jiaotong
退来|tuilai
利禄|lilu
不提|buti
解释一下|jieshiyixia
会多|huiduo
感觉|ganjue
线外|xianwai
变零|bianling
杂用|zayong
付软|furuan
重在|zhongzai
安月|anyue
用不起|yongbuqi
助学|zhuxue
第十一天|dishiyitian
这样一来|zheyangyilai
交不聊|jiaobuliao
钱数|qianshu
普通人|putongren
标识|biaozhi
负下|fuxia
回赠|huizeng
男朋友|nanpengyou
预付定金|yufudingjin
曾加|cengjia
正忙|zhengmang
寄来|jilai
体到|tidao
查一查|chayicha
发指|fazhi
绷|beng
分没长|fenmeizhang
置|zhi
nga|nga
友|you
99|99
解动|jiedong
l|l
完行|wanxing
自关|ziguan
时老|shilao
提|ti
帐|zhang
妹|mei
订飞|dingfei
中信|zhongxin
至下|zhixia
开局|kaiju
上换|shanghuan
考察|kaocha
没付|meifu
当前|dangqian
尽快|jinkuai
名细|mingxi
接到|jiedao
少夫|shaofu
减了|jianle
假期|jiaqi
再说|zaishuo
用车|yongche
付|fu
工资|gongzi
度后|duhou
附有|fuyou
企业会员|qiyehuiyuan
第月|diyue
无原|wuyuan
明星|mingxing
变短|bianduan
老大|laoda
baleno|baleno
元钱|yuanqian
明年|mingnian
刚收|gangshou
下面|xiamian
消失|xiaoshi
看好|kanhao
掉线|diaoxian
说话|shuohua
伸请|shenqing
交易额|jiaoyie
商家|shangjia
元下|yuanxia
我刷错|woshuacuo
全部|quanbu
钱放|qianfang
行驶证|xingshizheng
录像|luxiang
幅度|fudu
未付|weifu
迁移|qianyi
负算|fusuan
往回|wanghui
什付|shenfu
三张|sanzhang
单笔|danbi
作废|zuofei
∨|∨
交酷|jiaoku
接|jie
对方|duifang
一可|yike
已清|yiqing
几久|jijiu
申请材料|shenqingcailiao
占无发|zhanwufa
清后|qinghou
关团|guantuan
越高|yuegao
棒|bang
高度|gaodu
我永|woyong
意|yi
手机号码|shoujihaoma
点成|diancheng
值能|zhineng
打比方|dabifang
少人用|shaorenyong
大润发|darunfa
摸|mo
住会|zhuhui
那家|najia
需先|xuxian
mp|mp
专户|zhuanhu
从扣|congkou
事情|shiqing
宝宝|baobao
起用|qiyong
华为|huawei
这分|zhefen
所用|suoyong
干预|ganyu
操作失误|caozuoshiwu
通讯联系|tongxunlianxi
会儿|huier
告诉|gaosu
衣服|yifu
值上|zhishang
以下|yixia
.......|.......
多缴|duojiao
始终|shizhong
安逸|anyi
加恶|jiae
多会涨|duohuizhang
机蜜里|jimili
第二笔|dierbi
状|zhuang
吃火锅|chihuoguo
不论|bulun
氣費|qifei
要久|yaojiu
余额|yue
征行|zhengxing
礼是|lishi
根|gen
抹|mo
其它|qita
有项|youxiang
审阅|shenyue
十几号|shijihao
包月|baoyue
截款期|jiekuanqi
试活|shihuo
乡情|xiangqing
店门|dianmen
oppor|oppor
线儿|xianer
本科|benke
购占|gouzhan
衣架|yijia
坑钱|kengqian
房屋贷款|fangwudaikuan
几钱|jiqian
赚入|zhuanru
中银|zhongyin
159|159
上留|shangliu
再来|zailai
券用|quanyong
点亮|dianliang
另个|lingge
求求|qiuqiu
背带|beidai
补交|bujiao
昨天上午|zuotianshangwu
额慢|eman
退得款|tuidekuan
十二号|shierhao
我传|wochuan
出理|chuli
选项|xuanxiang
化费|huafei
竖式|shushi
最多会|zuiduohui
国美|guomei
上来|shanglai
只想|zhixiang
每比有|meibiyou
闪退|shantui
查分|chafen
已致|yizhi
扣分|koufen
渠县|quxian
沒有|meiyou
偷用|touyong
丹尼斯|dannisi
扣过|kouguo
能交|nengjiao
押|ya
罚钱|faqian
咋样|zayang
想买个|xiangmaige
圆|yuan
领了|lingle
过货|guohuo
能试|nengshi
压|ya
不太|butai
973|973
最新|zuixin
失约|shiyue
过多|guoduo
会用|huiyong
期|qi
强迫|qiangpo
招商|zhaoshang
再进|zaijin
有事没事|youshimeishi
沙|sha
存到|cundao
欠会|qianhui
手费|shoufei
啧关|zeguan
千牛|qianniu
存款|cunkuan
因|yin
周围|zhouwei
哪几种|najizhong
丫头|yatou
夂|zhi
可供|kegong
彼岸|bian
跨|kua
招联能|zhaolianneng
碼找|mazhao
五笔|wubi
第一个|diyige
周有|zhouyou
及设|jishe
日靠|rikao
四十五天|sishiwutian
哪里|nali
六十|liushi
港澳|gangao
从前|congqian
很棒|henbang
旅店|lvdian
臨時|linshi
长期|changqi
实品|shipin
调升|diaosheng
洗车场|xichechang
万三涨|wansanzhang
多出|duochu
环款|huankuan
多元|duoyuan
蚁|yi
别|bie
能举|nengju
调不高|diaobugao
结清|jieqing
扣光|kouguang
真是|zhenshi
得|de
检查|jiancha
优惠活动|youhuihuodong
人刚|rengang
多为|duowei
一百多|yibaiduo
拿|na
路口|lukou
通话费|tonghuafei
除小蓝|chuxiaolan
分摊|fentan
耶|ye
利息费用|lixifeiyong
息金|xijin
试过|shiguo
奇怪|qiguai
丁|ding
控制|kongzhi
初|chu
有意思|youyisi
款会额|kuanhuie
火车|huoche
加盟|jiameng
二代|erdai
日起|riqi
提大|tida
到达|daoda
过得|guode
中充|zhongchong
付清|fuqing
远离|yuanli
又付|youfu
权利|quanli
下旬|xiaxun
中午|zhongwu
155|155
语气|yuqi
拾元|shiyuan
借算|jiesuan
查有|chayou
没用到|meiyongdao
之外|zhiwai
永远都是|yongyuandoushi
开再|kaizai
没交|meijiao
金要|jinyao
来电|laidian
美宜加|meiyijia
选着|xuanzhe
借到|jiedao
总说|zongshuo
晚一点|wanyidian
回帐|huizhang
转不钱|zhuanbuqian
购能|gouneng
便|bian
冲钱|chongqian
太久|taijiu
满地|mande
改回|gaihui
够期|gouqi
181|181
款卷|kuanjuan
引导|yindao
课|ke
因素|yinsu
读书|dushu
厂|chang
纳入|naru
红蚂蚁|hongmayi
阔以|kuoyi
我录|wolu
那长|nazhang
明细表|mingxibiao
找人贷|zhaorendai
俞|yu
最大|zuida
一类|yilei
再令|zailing
颌度|hedu
细数|xishu
封控|fengkong
场所|changsuo
答案|daan
外国人|waiguoren
天雪凌|tianxueling
显是|xianshi
率|lv
图是|tushi
什不从|shenbucong
不见|bujian
两元|liangyuan
我外|wowai
己用|jiyong
压金|yajin
能涨|nengzhang
签收|qianshou
紧|jin
额服|efu
本单|bendan
要换|yaohuan
截至|jiezhi
没换|meihuan
一查|yicha
刚交过|gangjiaoguo
点时|dianshi
按到|andao
小额|xiaoe
没邦定|meibangding
扣不去|koubuqu
阳光|yangguang
扣清|kouqing
有车|youche
我常|wochang
抡|lun
bux|bux
鸡|ji
查问|chawen
哪冲|nachong
哪换|nahuan
循序|xunxu
百货|baihuo
不烦|bufan
法宝|fabao
没花贝|meihuabei
人脉关系|renmaiguanxi
运送|yunsong
最快|zuikuai
超期|chaoqi
期限内|qixiannei
换张|huanzhang
退订|tuiding
三种|sanzhong
不太敢|butaigan
扫描|saomiao
反回|fanhui
用天|yongtian
信低|xindi
结洼|jiewa
美法用|meifayong
后补|houbu
前提|qianti
调分|diaofen
提前结束|tiqianjieshu
我网|wowang
至|zhi
用会收|yonghuishou
网商|wangshang
白动|baidong
照|zhao
钱退|qiantui
十多元|shiduoyuan
清远市|qingyuanshi
点款|diankuan
早期|zaoqi
将|jiang
戚用|qiyong
备用金|beiyongjin
开套|kaitao
繳|jiao
还花唄|haihuabei
门牌号|menpaihao
组成|zucheng
换钱|huanqian
十一月份|shiyiyuefen
真实性|zhenshixing
别动|biedong
姓名|xingming
只好|zhihao
摄像头|shexiangtou
还算正|haisuanzheng
接换|jiehuan
总共|zonggong
计数|jishu
完全|wanquan
最高值|zuigaozhi
客问|kewen
双休|shuangxiu
从来不|conglaibu
苹果|pingguo
想往|xiangwang
待|dai
奇货能|qihuoneng
系统故障|xitongguzhang
二张|erzhang
边|bian
没找|meizhao
一个|yige
门头|mentou
初始化|chushihua
微店|weidian
什在|shenzai
减少|jianshao
流动|liudong
并入|bingru
用起|yongqi
意味着|yiweizhe
只见|zhijian
期限|qixian
请开|qingkai
芝|zhi
频繁|pinfan
一能加|yinengjia
捆绑|kunbang
传上去|chuanshangqu
尽快恢复|jinkuaihuifu
快手|kuaishou
概率|gailv
我得|wode
转转|zhuanzhuan
摊贩|tanfan
部份|bufen
天借|tianjie
升纸|shengzhi
愿不愿意|yuanbuyuanyi
账要|zhangyao
公司地址|gongsidizhi
负起|fuqi
所有|suoyou
短信通|duanxintong
银座|yinzuo
能开|nengkai
湘江|xiangjiang
遇|yu
蘑菇|mogu
停说|tingshuo
元分|yuanfen
通过|tongguo
手工|shougong
小型|xiaoxing
服务器|fuwuqi
转接|zhuanjie
ktv|ktv
填嘛|tianma
上麦|shangmai
这能|zheneng
何将|hejiang
最多缴|zuiduojiao
提生|tisheng
用点|yongdian
能生|nengsheng
增额|zenge
认用|renyong
再也不会|zaiyebuhui
文玩|wenwan
涵|han
感谢|ganxie
sta|sta
加多少|jiaduoshao
赚取|zhuanqu
好|hao
原先|yuanxian
接借|jiejie
收益|shouyi
几月|jiyue
欧尚|oushang
已解|yijie
零元|lingyuan
发了|fale
螞蟻|mayi
尽请|jinqing
过久会|guojiuhui
不太想|butaixiang
要出|yaochu
款时|kuanshi
五十六|wushiliu
锁|suo
十一|shiyi
扣减|koujian
微码|weima
自功|zigong
开闭|kaibi
那就是说|najiushishuo
信任度|xinrendu
加额|jiae
缓缓|huanhuan
订货|dinghuo
支改|zhigai
能出|nengchu
改过|gaiguo
欠缺|qianque
天后|tianhou
没清|meiqing
活|huo
随时|suishi
邮件|youjian
e|e
最低标准|zuidibiaozhun
相电|xiangdian
要息|yaoxi
珠宝|zhubao
十几天|shijitian
乙|yi
万五|wanwu
值才|zhicai
看见|kanjian
专业|zhuanye
不朽|buxiu
变更|biangeng
用券|yongquan
晚|wan
要不得|yaobude
国内|guonei
二月|eryue
能决|nengjue
一过|yiguo
二百多块|erbaiduokuai
失业|shiye
用句|yongju
回付|huifu
部有|buyou
营业|yingye
付错|fucuo
闲|xian
我姐|wojie
自定|ziding
改价后|gaijiahou
骗子|pianzi
负对|fudui
改用|gaiyong
谢天谢地|xietianxiedi
佝|gou
好几万|haojiwan
恁|nen
款要|kuanyao
告知|gaozhi
办完|banwan
還嗎|haima
体现|tixian
入口关|rukouguan
换得|huande
上上个月|shangshanggeyue
开嘛|kaima
处于|chuyu
打勾|dagou
荣耀|rongyao
鞋字|xiezi
智慧|zhihui
该开|gaikai
每月|meiyue
算了算|suanlesuan
可|ke
定金|dingjin
付错款|fucuokuan
不能|buneng
人民币|renminbi
有够|yougou
相符|xiangfu
网银|wangyin
随取|suiqu
最慢|zuiman
永|yong
白猫|baimao
购房|goufang
刚才|gangcai
不发|bufa
奥康|aokang
拿出|nachu
还关|haiguan
如果|ruguo
油钱|youqian
为合会|weihehui
聚|ju
玩意|wanyi
心|xin
批次|pici
取有|quyou
流失|liushi
领|ling
怎扫|zensao
代理|daili
开道|kaidao
保号|baohao
计算机|jisuanji
返钱|fanqian
抽圈|chouquan
身份证号|shenfenzhenghao
持卡人|chikaren
不高|bugao
改先息|gaixianxi
爱人|airen
四月份|siyuefen
重|zhong
成先息|chengxianxi
账上|zhangshang
降额|jiange
物料|wuliao
邮寄|youji
查出|chachu
住宿|zhusu
证据|zhengju
时|shi
调改|diaogai
ab|ab
万分之三|wanfenzhisan
不亮|buliang
负面影响|fumianyingxiang
r|r
有满|youman
世纪|shiji
选错|xuancuo
付不来|fubulai
怎什能|zenshenneng
有分|youfen
人像|renxiang
提问|tiwen
哪些地方|neixiedifang
六百多分|liubaiduofen
我调|wodiao
平|ping
起到|qidao
我办|woban
借能|jieneng
先交|xianjiao
什钱|shenqian
勒|lei
过期|guoqi
充不起|chongbuqi
绝味|juewei
能长|nengzhang
北京|beijing
算到|suandao
中密付|zhongmifu
获得|huode
先开|xiankai
全息|quanxi
往冲|wangchong
开了个|kailege
实付|shifu
减分|jianfen
还个|haige
没查|meicha
手有|shouyou
申核|shenhe
大众|dazhong
几张|jizhang
手软|shouruan
计算错误|jisuancuowu
我选|woxuan
中下|zhongxia
零散|lingsan
性能|xingneng
平次|pingci
白色|baise
封会|fenghui
光|guang
事嘛|shima
实际上|shijishang
上付|shangfu
问号|wenhao
递增|dizeng
预借|yujie
卡住|kazhu
运行|yunxing
面临|mianlin
nb|nb
中段|zhongduan
今早|jinzao
扮|ban
笔款|bikuan
最能|zuineng
被关|beiguan
个人身份|gerenshenfen
超|chao
况且|kuangqie
多花钱|duohuaqian
间接|jianjie
冻住|dongzhu
不要脸|buyaolian
升级成|shengjicheng
比如|biru
电力|dianli
发起|faqi
急时|jishi
分六斯|fenliusi
用成|yongcheng
全数|quanshu
怎付|zenfu
什么游戏|shenmeyouxi
花呗|huabei
连线|lianxian
天到|tiandao
21|21
调款|diaokuan
改过来|gaiguolai
算出|suanchu
两样|liangyang
渝期|yuqi
還清|haiqing
点计|dianji
怎降|zenjiang
元内|yuannei
联系地址|lianxidizhi
鈤|ri
房费|fangfei
一些|yixie
暖气费|nuanqifei
抽中|chouzhong
xk|xk
代发|daifa
第一行|diyixing
换卡|huanka
我滴|wodi
尔|er
去存|qucun
度加|dujia
银泰宝|yintaibao
对错|duicuo
没期|meiqi
面值|mianzhi
和|he
试运行|shiyunxing
分润|fenrun
花出|huachu
就让|jiurang
对涨|duizhang
提什|tishen
我想调|woxiangdiao
这下|zhexia
这快|zhekuai
挺升|tingsheng
佳|jia
一次次|yicici
空间|kongjian
钱花|qianhua
伍仟|wuqian
时期|shiqi
钱会|qianhui
零事|lingshi
笔要|biyao
联想|lianxiang
换码|huanma
底于|diyu
笔回|bihui
vivox|vivox
爆增|baozeng
单|dan
我要|woyao
先|xian
数要|shuyao
die|die
从而|conger
分嘛|fenma
不花|buhua
分越|fenyue
很快|henkuai
十月底|shiyuedi
一才|yicai
到实|daoshi
领域|lingyu
时以|shiyi
返现|fanxian
点里|dianli
讨论|taolun
瑜|yu
一体|yiti
发交|fajiao
o|o
上少|shangshao
比钱|biqian
券不发|quanbufa
二满|erman
不清|buqing
一比钱|yibiqian
座|zuo
怎冻接|zendongjie
用卡能|yongkaneng
用奶|yongnai
一声|yisheng
度减|dujian
门槛|menkan
无要|wuyao
贷额|daie
马|ma
好多年|haoduonian
嫁接|jiajie
我过|woguo
会停|huiting
不付|bufu
不起|buqi
小号|xiaohao
周卡能|zhoukaneng
查得|chade
招牌|zhaopai
给钱|geiqian
期可|qike
现息|xianxi
信任|xinren
概念|gainian
就查|jiucha
大乐透|daletou
qianq|qianq
挽|wan
深|shen
分息|fenxi
搞|gao
我想|woxiang
退回来|tuihuilai
没换款|meihuankuan
关逼|guanbi
＼|＼
于期|yuqi
绝密|juemi
未成年|weichengnian
哪项|naxiang
接出|jiechu
七万|qiwan
间隔时间|jiangeshijian
鱼|yu
日变|ribian
丫|ya
后付|houfu
被盗|beidao
养殖|yangzhi
常熟市|changshushi
没多|meiduo
苦恼|kunao
困惑|kunhuo
我现|woxian
老显用|laoxianyong
单月|danyue
微信里|weixinli
发货|fahuo
住用|zhuyong
无能为力|wunengweili
转出去|zhuanchuqu
能下|nengxia
日试|rishi
图片|tupian
一天|yitian
留着|liuzhe
再升|zaisheng
再试|zaishi
查查|zhazha
不弄交|bunongjiao
不和集|buheji
张票|zhangpiao
路上|lushang
太|tai
结账|jiezhang
剐|gua
挨扣|aikou
信加|xinjia
定位|dingwei
创业基金|chuangyejijin
杳|yao
有代款|youdaikuan
怎样才能|zenyangcaineng
病情|bingqing
封杀|fengsha
带付|daifu
扫二|saoer
陇南|longnan
利用|liyong
饭|fan
音乐|yinyue
一弄|yinong
好久|haojiu
允|yun
钱长|qianzhang
双击|shuangji
钱够|qiangou
月底|yuedi
压金退|yajintui
发工资|fagongzi
酒店|jiudian
变付|bianfu
商品信息|shangpinxinxi
过不去|guobuqu
银行信用|yinhangxinyong
吵|chao
能手|nengshou
手机|shouji
元收|yuanshou
能换现|nenghuanxian
想想|xiangxiang
枪|qiang
项链|xianglian
江苏|jiangsu
只限|zhixian
帮过|bangguo
以付|yifu
返利|fanli
期改|qigai
已受|yishou
能轮|nenglun
没刷|meishua
撤消|chexiao
款少|kuanshao
一在|yizai
前得|qiande
华夏|huaxia
渣|zha
操作方法|caozuofangfa
什额|shene
买什|maishen
签订协议|qiandingxieyi
年|nian
账号密码|zhanghaomima
失敗|shibai
退改|tuigai
零|ling
开头|kaitou
能得|nengde
調高|diaogao
何来|helai
过|guo
有影|youying
现钱|xianqian
费里|feili
得款|dekuan
工作人员|gongzuorenyuan
非要|feiyao
从开|congkai
还底|haidi
但付|danfu
追回|zhuihui
取消|quxiao
心悦|xinyue
大半年|dabannian
昨天中午|zuotianzhongwu
四千块|siqiankuai
实家|shijia
直在|zhizai
多一笔|duoyibi
没帮|meibang
钱且|qianqie
抢票|qiangpiao
退少|tuishao
换邦|huanbang
顺丰|shunfeng
现转|xianzhuan
我买件|womaijian
对会|duihui
钱太多|qiantaiduo
地区|diqu
应该|yinggai
封掉|fengdiao
设支|shezhi
会进|huijin
境外|jingwai
儿读|erdu
贞信|zhenxin
那新|naxin
大汉|dahan
饭店|fandian
能伸|nengshen
使|shi
关易|guanyi
响|xiang
网费|wangfei
提至|tizhi
烦心|fanxin
变差|biancha
怎摸|zenmo
膜拜|mobai
不买|bumai
闲鱼|xianyu
全天|quantian
我乃个|wonaige
输出|shuchu
既扣|jikou
再调|zaidiao
群聊|qunliao
没钱|meiqian
盒子|hezi
回去|huiqu
签订|qianding
做不了|zuobuliao
餐饮业|canyinye
后会|houhui
免去|mianqu
打车|dache
锦|jin
送来|songlai
资询|zixun
伏|fu
借嘛|jiema
摆地摊|baiditan
而是|ershi
